wwwwwwwwwwwww
w.......+.g1w
w.w.........w
w...........w
w...w...w.w.w
w...........w
wAw.w......2w
w...........w
wwwwwwwwwwwww
