wwwwwwwwwwwww
w...........w
w.....w.....w
w..........gw
w.2.........w
w.....A....2w
w+........w.w
w...........w
wwwwwwwwwwwww
