wwwwwwwwwwwww
w+.......1..w
w...w......3w
w...w...w..3w
w.wAw...www.w
w.....w.....w
w.ww..ww..wgw
w...........w
wwwwwwwwwwwww
