wwwwwwwwwwwww
w...w.....g.w
w3..w.w...w.w
w...........w
w+....w.w..3w
w.....w.....w
w.....www.www
w.....A.....w
wwwwwwwwwwwww
