wwwwwwwwwwwww
w...w.....22w
w.w.w...w.w.w
w..........gw
w..Aw.....w.w
w.w.........w
w.w...w..+..w
w.....w1....w
wwwwwwwwwwwww
