wwwwwwwwwwwww
w+.2....w...w
w.www.......w
w.w......3..w
w3..w...wwwgw
w...........w
w.w.w..Awww.w
w.......w...w
wwwwwwwwwwwww
