wwwwwwwwwwwww
w.........13w
w.....w.w.g.w
w...+.......w
w...www...w.w
w...w.......w
w.w.w.....w.w
wA..........w
wwwwwwwwwwwww
