wwwwwwwwwwwww
w.........w3w
w.w.w.w.....w
w...........w
wA..w...+.w.w
w...........w
w.....w....gw
w...........w
wwwwwwwwwwwww
