wwwwwwwwwwwww
w...1..A....w
w..w..w...w.w
w...........w
w.w.w.w...w.w
w...........w
wg........www
w1.........+w
wwwwwwwwwwwww
