wwwwwwwwwwwww
w...........w
w.w......A..w
w.1+........w
w...........w
w...........w
w...w.w.w...w
w.g.........w
wwwwwwwwwwwww
