wwwwwwwwwwwww
w...........w
w..1w.....w.w
w....A......w
w.........w.w
w...........w
w.....w.g...w
w.+........2w
wwwwwwwwwwwww
