wwwwwwwwwwwww
w.1.........w
w.w.w.......w
w.g...w.....w
w...w.w..Aw.w
w...w...w.w.w
w3w...www.w.w
w...+.......w
wwwwwwwwwwwww
