wwwwwwwwwwwww
w...A.......w
w.....w..+w.w
w...........w
w.w...w...w.w
w...........w
w.....w...w.w
w......2.3.gw
wwwwwwwwwwwww
