wwwwwwwwwwwww
w..........gw
w.w.........w
w...........w
w.....w.....w
w...........w
w...w.w+....w
wA..........w
wwwwwwwwwwwww
