wwwwwwwwwwwww
w...........w
w.....wA....w
w...........w
w.....w.w.w.w
wg..........w
w.w.w...w.w.w
w........+..w
wwwwwwwwwwwww
