wwwwwwwwwwwww
w...w.......w
w.......w.wgw
w...........w
w1......w.w.w
w...........w
w+....A...w.w
w...w.......w
wwwwwwwwwwwww
