wwwwwwwwwwwww
w..........2w
w...w.....w.w
w.g........+w
w1w.w.ww.ww.w
w.........w.w
w...w.w.....w
w.......A...w
wwwwwwwwwwwww
