wwwwwwwwwwwww
w....A......w
w+..w..ww...w
w.........w.w
w...w...w.www
w...........w
w..........gw
w..........3w
wwwwwwwwwwwww
