wwwwwwwwwwwww
w...........w
w.A....ww...w
w..........+w
w.w.w...w...w
w.........w.w
w.......wg..w
w.......2...w
wwwwwwwwwwwww
