wwwwwwwwwwwww
w...........w
wA..w.w..w..w
w...........w
w......3ww..w
w...+.w.....w
w.......w3w.w
w.........g.w
wwwwwwwwwwwww
