wwwwwwwwwwwww
w+..........w
w.....w.....w
w.........A.w
w.......w...w
w...........w
w...w.....w.w
w.g.........w
wwwwwwwwwwwww
