wwwwwwwwwwwww
w.........g.w
w.......w...w
w..........3w
w.wAw...w...w
w...........w
w.w.........w
w+..........w
wwwwwwwwwwwww
