wwwwwwwwwwwww
w.....w.....w
w...w.wAw..ww
w...w......+w
w...w.w..ww.w
w...........w
wgw...w...w3w
w........2..w
wwwwwwwwwwwww
