wwwwwwwwwwwww
w.2g........w
w....ww.....w
w.......w.w.w
w3.w.ww.w.w.w
w.......w...w
w..ww...w...w
w.......wAw+w
wwwwwwwwwwwww
