wwwwwwwwwwwww
w...+.......w
w.w...w.w.w.w
w......Aw...w
w1....w.....w
w...........w
w.w3w.w.w.w.w
w..........gw
wwwwwwwwwwwww
