wwwwwwwwwwwww
w.......w...w
w.w...2.....w
w...........w
w.2...w.w..ww
w.......A...w
wg....ww....w
w..........+w
wwwwwwwwwwwww
