wwwwwwwwwwwww
w...........w
w........Aw.w
w...........w
w.w.w.......w
w.+.........w
wg......w...w
w..2........w
wwwwwwwwwwwww
