wwwwwwwwwwwww
wg..........w
w.....w.....w
w.....A.....w
w...........w
w...........w
w.w........3w
w..........+w
wwwwwwwwwwwww
