wwwwwwwwwwwww
w2.3......3.w
w.w.w....g..w
w...........w
w.w+w.www...w
w.w.....w...w
w.w...w...www
w....A..w...w
wwwwwwwwwwwww
