wwwwwwwwwwwww
w...........w
w.w...w.....w
w.+........1w
w.....w.....w
w.........g.w
w....Aw.....w
w...........w
wwwwwwwwwwwww
