wwwwwwwwwwwww
w...A.......w
w.........w.w
w...........w
w.........g.w
w...........w
w+..w.w...w.w
w.........3.w
wwwwwwwwwwwww
