wwwwwwwwwwwww
w.A.........w
w.....w.w...w
w...........w
w.......w.w2w
w.........3.w
w.w.w.....w.w
w...+.....g.w
wwwwwwwwwwwww
