wwwwwwwwwwwww
wA........w.w
w.........w.w
w...........w
w.ww......w.w
w.....w.....w
w.w...w.w3wgw
w....+w..1..w
wwwwwwwwwwwww
