wwwwwwwwwwwww
w..........gw
w.....w.w..+w
w...........w
w...w...w.w.w
w...........w
w...w.....w.w
wA........2.w
wwwwwwwwwwwww
