wwwwwwwwwwwww
wA....w.....w
ww....w..w.ww
w...........w
w.w...w.w1..w
w...w...w..2w
w.+.w...w.wgw
w.......3...w
wwwwwwwwwwwww
