wwwwwwwwwwwww
wA..........w
w.w.w...w...w
w...........w
w.......w.w.w
w.....+.....w
w.w........gw
w..........1w
wwwwwwwwwwwww
