wwwwwwwwwwwww
w...........w
w.w.wA..w...w
w...........w
w........g..w
w...........w
w.+.w....2..w
w...........w
wwwwwwwwwwwww
