wwwwwwwwwwwww
w+..........w
w.....w.2.w.w
w...........w
w...w.w....gw
w...........w
w...........w
wA..........w
wwwwwwwwwwwww
