wwwwwwwwwwwww
w...........w
w+w.ww..w.wgw
w.w......1..w
w.w.w.w.w.w3w
w..A..w3....w
w.....w.www.w
w.w.........w
wwwwwwwwwwwww
