wwwwwwwwwwwww
w.........A.w
w1w.w.w.w...w
w.w.........w
w.w+..w...w.w
wg....w.....w
w...w.w.w.w.w
w.1.........w
wwwwwwwwwwwww
