wwwwwwwwwwwww
w...w....A..w
w...w...w...w
w.......w...w
w...w......+w
w.w.........w
w2w.ww......w
w.g1....w...w
wwwwwwwwwwwww
