wwwwwwwwwwwww
w...w......3w
w.w.w..wwgwww
w.........2.w
wA....w.....w
w...........w
w.+.w.w.....w
w...........w
wwwwwwwwwwwww
