wwwwwwwwwwwww
wg..2.....w.w
w3www....ww.w
w..2w.......w
w.w...w.....w
w...........w
w.w...w.wA..w
w...w...w..+w
wwwwwwwwwwwww
