wwwwwwwwwwwww
w..A........w
w...w.w.w.w.w
w...........w
w.......w.w.w
w...........w
w.w...wg..2.w
w+......2...w
wwwwwwwwwwwww
