wwwwwwwwwwwww
w..1........w
w...w...w+..w
w...........w
w...w...w...w
w...........w
wg..w.......w
w.......A...w
wwwwwwwwwwwww
