wwwwwwwwwwwww
w.......+...w
w.......w.w.w
w...........w
w......Aw...w
w...........w
w.w.w.......w
w3g.........w
wwwwwwwwwwwww
