wwwwwwwwwwwww
w..+........w
w...w.....w.w
w...........w
w.........wAw
w...........w
w.w.........w
w3g.........w
wwwwwwwwwwwww
