wwwwwwwwwwwww
w+..........w
w.w.w...2...w
w...........w
w.........w.w
w..A........w
w...ww....w.w
w........g..w
wwwwwwwwwwwww
