wwwwwwwwwwwww
wA........+.w
w.....w.....w
w...........w
w.....w.w.w.w
w...........w
w.w.w.w....1w
w........g2.w
wwwwwwwwwwwww
