wwwwwwwwwwwww
w...........w
wA..w.......w
w...........w
w....+......w
w..........3w
w...w.w....gw
w...........w
wwwwwwwwwwwww
