wwwwwwwwwwwww
w.........2.w
w.A...w...w.w
w...........w
w.....w+ww..w
w.......g...w
w.w..w......w
w.......2...w
wwwwwwwwwwwww
