wwwwwwwwwwwww
w.....2.w..+w
w...w...ww..w
w...w.......w
w.www...wAwww
w.w.........w
w...ww...ww.w
w3g.........w
wwwwwwwwwwwww
