wwwwwwwwwwwww
w...w.w.3.w.w
ww..w.w..3..w
w..........gw
w.w.w.w.w.www
w...........w
www.www.www.w
wA....w+....w
wwwwwwwwwwwww
