wwwwwwwwwwwww
w.+.2.......w
w..3www..ww.w
w...........w
w.w.....w.w.w
w.w..g...A..w
w.w..w..w.w.w
w...........w
wwwwwwwwwwwww
