wwwwwwwwwwwww
w.......+...w
w.....w.....w
w...........w
w.Aw..w...w.w
w...........w
w...w.......w
w.........g1w
wwwwwwwwwwwww
