wwwwwwwwwwwww
w...w..+....w
w..2w.......w
w...........w
w.w...w.wwA.w
w...........w
w....ww.....w
wg..........w
wwwwwwwwwwwww
