wwwwwwwwwwwww
w+..........w
w.......w.A.w
w...........w
w.......w.w.w
w...........w
w...........w
w.1.g.......w
wwwwwwwwwwwww
