wwwwwwwwwwwww
w...........w
w........2w.w
w....A......w
w.........w.w
w..........gw
w.....w.w...w
w+.........1w
wwwwwwwwwwwww
