wwwwwwwwwwwww
w3......+...w
w...w.......w
w...........w
w.....w.....w
wg.........Aw
w.........w.w
w...........w
wwwwwwwwwwwww
