wwwwwwwwwwwww
w.3.........w
w+..wgw...w.w
w...........w
w.....w...w.w
w...........w
w.....w.....w
w........A..w
wwwwwwwwwwwww
