wwwwwwwwwwwww
w...........w
w...w.w...wAw
w...........w
w...w.....w.w
w...........w
w...w.....w.w
w.g+1.......w
wwwwwwwwwwwww
