wwwwwwwwwwwww
w2..........w
w.w........gw
w...........w
w.....w.w.w.w
w+..........w
w.w.wA..w.w.w
w...........w
wwwwwwwwwwwww
