wwwwwwwwwwwww
w+.........gw
w.....w...w3w
w...........w
w.2.........w
w.....A.....w
w.w...w.....w
w...........w
wwwwwwwwwwwww
