wwwwwwwwwwwww
w.........g1w
w.....w.....w
w...........w
w...w.w.....w
w...........w
w.A.w.w.....w
w+..........w
wwwwwwwwwwwww
