wwwwwwwwwwwww
w...........w
w...w.w+..w.w
wA..........w
w...w.w.w.w.w
w...........w
w.....w....3w
w..........gw
wwwwwwwwwwwww
