wwwwwwwwwwwww
w.......w.21w
w.....w.w.wgw
w...........w
www...w.w.w.w
wA........w.w
w....ww.www.w
w.......+...w
wwwwwwwwwwwww
