wwwwwwwwwwwww
w..........1w
w.w.w.....w.w
wA..........w
w...w.w.....w
w..........gw
w...........w
w...+......2w
wwwwwwwwwwwww
