wwwwwwwwwwwww
w...........w
w.w.w.w.w...w
w.........A.w
w.........w.w
wg.1........w
w.w.........w
w..+........w
wwwwwwwwwwwww
