wwwwwwwwwwwww
w..........3w
wA..w...w...w
w...........w
w.....w.....w
w......+....w
w...w.w.....w
w.......g...w
wwwwwwwwwwwww
