wwwwwwwwwwwww
w..........1w
w.w.w...wwwww
w..A..w...+.w
w.w.w.w.w.www
w...........w
ww..w.w.w.w.w
w...w2.g..1.w
wwwwwwwwwwwww
