wwwwwwwwwwwww
wg.1........w
w.w.........w
w...........w
w.w...w.....w
w...........w
w.......w...w
w.......A..+w
wwwwwwwwwwwww
