wwwwwwwwwwwww
w3.........Aw
w...w.......w
w...g.......w
w.....w.....w
w...........w
w.+...w.....w
w...........w
wwwwwwwwwwwww
