wwwwwwwwwwwww
w...........w
w.w...w...+1w
w..g........w
w.w.......w.w
w...........w
w.w...w.....w
w......A....w
wwwwwwwwwwwww
