wwwwwwwwwwwww
w..g........w
w2......w...w
w.........+.w
w.....w.w...w
w...........w
w.w.w.w.....w
w........A..w
wwwwwwwwwwwww
