wwwwwwwwwwwww
w2.g........w
w.w...ww.ww.w
w......1....w
w...w.w...www
w.+.........w
w.w...w...w.w
w.......A...w
wwwwwwwwwwwww
