wwwwwwwwwwwww
w..2........w
w.+...w...w.w
w..........Aw
w.w...w...w.w
w...........w
w.w.......w.w
w..g2.......w
wwwwwwwwwwwww
