wwwwwwwwwwwww
w+..........w
w..........Aw
w...........w
w.....w.....w
w...........w
w...w.w...w.w
w.....g.....w
wwwwwwwwwwwww
