wwwwwwwwwwwww
w...w+......w
w..A......w.w
w...........w
w........2..w
w...........w
w.w.....w.g.w
w....1......w
wwwwwwwwwwwww
