wwwwwwwwwwwww
w+....w....gw
w2..w.....w.w
w.w.........w
w1w.w..www..w
w......A....w
w...w.w.w...w
w...........w
wwwwwwwwwwwww
