wwwwwwwwwwwww
w......2....w
w.....w.....w
w...........w
w.g...w.....w
w...........w
w.w.....w..+w
w........A..w
wwwwwwwwwwwww
