wwwwwwwwwwwww
w.A.........w
w.ww...+w.3.w
w...........w
w.www.w...www
w........g..w
w.w.w...w.w.w
w..........2w
wwwwwwwwwwwww
