wwwwwwwwwwwww
wg..........w
w3....w.w.w.w
w...........w
w.....w.A...w
w...........w
w.w.w.....w.w
w.3........+w
wwwwwwwwwwwww
