wwwwwwwwwwwww
w......A....w
w...w...w..ww
w...........w
w...w...w.+.w
w...1.......w
w.....w...w.w
w.wg.3......w
wwwwwwwwwwwww
