wwwwwwwwwwwww
w........2.gw
w.w.....w.w.w
w...........w
w.www...w...w
w.....w.....w
w2+...w.wwwww
w....Aw.....w
wwwwwwwwwwwww
