wwwwwwwwwwwww
w...........w
w.wgw.w.....w
w......A....w
w.........w.w
w...........w
w........+w.w
w...........w
wwwwwwwwwwwww
