wwwwwwwwwwwww
w...........w
w.w...+.....w
w...........w
wAw...w.w.w.w
w...........w
w.......w.wgw
w......3....w
wwwwwwwwwwwww
