wwwwwwwwwwwww
w.3.....+...w
w.....w.w.w.w
w...........w
w.w.w.A...w.w
w...w......2w
wg..www.w...w
w...........w
wwwwwwwwwwwww
