wwwwwwwwwwwww
w...w.w....gw
w.w.w...w.3.w
w.......2...w
w.....www.w.w
w...A.w.....w
w+..w.w...w.w
w.w.......w.w
wwwwwwwwwwwww
