wwwwwwwwwwwww
w....+......w
w.....w...w.w
w..........2w
w...w.w...w.w
w..A.......gw
w...w.....w.w
w...........w
wwwwwwwwwwwww
