wwwwwwwwwwwww
w...w.......w
w.w...ww..w+w
w.w...w...A.w
w.w.....w...w
w...w...w...w
w1w.www.w.w.w
wg....1...w2w
wwwwwwwwwwwww
