wwwwwwwwwwwww
w+.3.....3.gw
w...w.......w
w...........w
w.w.....w.w.w
w....A......w
w.w...w.w...w
w...........w
wwwwwwwwwwwww
