wwwwwwwwwwwww
w........1..w
w...w...w.w1w
w.....w...wgw
w.wAw.....w.w
w...........w
w.www.ww..w.w
w+....w.....w
wwwwwwwwwwwww
