wwwwwwwwwwwww
w...........w
w.w.....w+w.w
w.A.........w
w.w...w.w...w
w...........w
w.........w2w
w.........g3w
wwwwwwwwwwwww
