wwwwwwwwwwwww
w.g.........w
w.w.....w..ww
w...........w
w.w.......3.w
w.....A.....w
w.w...w....1w
w..........+w
wwwwwwwwwwwww
