wwwwwwwwwwwww
w...........w
w.w.w.......w
w..A........w
w...w.w....ww
w.....w.....w
w.........g.w
w.+.....w.1.w
wwwwwwwwwwwww
