wwwwwwwwwwwww
w2w2..w.....w
w.w.w...w.w.w
w......A..+.w
w.w.wwwww.www
w..3..w.....w
www.w.w...w.w
w.g.........w
wwwwwwwwwwwww
