wwwwwwwwwwwww
w.g.w.......w
w...w.w...w2w
w.2...w.....w
ww.w..ww.+w.w
w...........w
w...w...w.w.w
w.....A.w...w
wwwwwwwwwwwww
