wwwwwwwwwwwww
w.+.........w
w...........w
w...........w
w.....w.....w
w...........w
w.w.w.w....gw
w..A........w
wwwwwwwwwwwww
