wwwwwwwwwwwww
w.......g...w
w.w.....w.w.w
w...........w
w...w.......w
w...........w
w.....w....+w
wA.........2w
wwwwwwwwwwwww
