wwwwwwwwwwwww
w.......w.A.w
w.w...w.....w
w...........w
w2w........ww
w.w...w+....w
w.w.....www.w
w.....g..2..w
wwwwwwwwwwwww
