wwwwwwwwwwwww
w.........A.w
w......ww.w.w
w...........w
w.3...ww.w..w
w....g......w
w.....w..ww.w
w.+...w.....w
wwwwwwwwwwwww
