wwwwwwwwwwwww
w.+...A.....w
w.........w.w
w...........w
w.....w.w.w1w
w........g..w
w...w...w...w
w...........w
wwwwwwwwwwwww
