wwwwwwwwwwwww
wg..........w
w...........w
w.....w.....w
w...w.w.....w
w...........w
w...ww..A...w
w1........+.w
wwwwwwwwwwwww
