wwwwwwwwwwwww
w3....A.....w
w.w.w.w.w...w
w...........w
w+.w..w.w.w.w
w.......w...w
w.w..ww..g.2w
w....1..w.w.w
wwwwwwwwwwwww
