wwwwwwwwwwwww
wg........w.w
w...+.......w
w3......w...w
w.w.......w.w
w.....w.....w
w.w...w.w...w
w........A..w
wwwwwwwwwwwww
