wwwwwwwwwwwww
w..A........w
w.......w.w.w
w...........w
w.w...w.w.w.w
w...........w
w.........w.w
w.+..2...g..w
wwwwwwwwwwwww
