wwwwwwwwwwwww
w..........3w
w...w.......w
w...........w
wA..w.w.....w
w..........gw
w...ww..w1w.w
w..+......w.w
wwwwwwwwwwwww
