wwwwwwwwwwwww
w1...g..w.w.w
w...w...w.w.w
w+......w...w
w2.wwwwww.w.w
w.....w.w...w
w.w...w....Aw
w.w.......w.w
wwwwwwwwwwwww
