wwwwwwwwwwwww
w..A........w
w.w.w.......w
w..........+w
w...w....ww.w
w.........w.w
w...w.w.www1w
w.w.w.3..g..w
wwwwwwwwwwwww
