wwwwwwwwwwwww
w+3.........w
w.w.w......gw
w...........w
w.....w.....w
w...........w
w.....w.....w
w.....A.....w
wwwwwwwwwwwww
