wwwwwwwwwwwww
w...........w
w.w...+.ww..w
w.......w...w
w...w...w.w3w
w..A......w.w
w.w.w.w...wgw
w.......1...w
wwwwwwwwwwwww
