wwwwwwwwwwwww
w...........w
wgw.....w.w.w
w...........w
w...w.w.w..Aw
w..3........w
w...........w
w........+..w
wwwwwwwwwwwww
