wwwwwwwwwwwww
w...3g......w
w+......w...w
w...w.......w
w1..www.w.wAw
w...........w
w.ww...w....w
w.1.........w
wwwwwwwwwwwww
