wwwwwwwwwwwww
w.2.....g...w
w.w.w.w.ww..w
w.....2....+w
w.w.w.w..wwww
w...........w
w..Aw.w.www.w
w...........w
wwwwwwwwwwwww
