wwwwwwwwwwwww
w.........2gw
w...www....ww
w......1...3w
w.........w.w
w..+..w...w.w
w.w.w.w...w.w
w.A...w.w...w
wwwwwwwwwwwww
