wwwwwwwwwwwww
w.1.........w
w.wg..w.w.w.w
w...........w
w.......w.A.w
w...........w
w.....+...w.w
w...........w
wwwwwwwwwwwww
