wwwwwwwwwwwww
w...........w
w.w.w...w...w
wg..........w
w...w...w...w
w.3....A....w
w...w...w...w
w........+..w
wwwwwwwwwwwww
