wwwwwwwwwwwww
w..........+w
w3w.w.w...w.w
w.w.........w
w.w.ww.wA.www
w.g.w.......w
ww.......w.ww
w2..........w
wwwwwwwwwwwww
