wwwwwwwwwwwww
w...........w
w3w...w.....w
w...........w
w2wg..w.....w
w...........w
w.w...w...A.w
w+..........w
wwwwwwwwwwwww
