wwwwwwwwwwwww
w.1.........w
wgww........w
w1..........w
w.w......w..w
w.w.........w
w.w.....A...w
w.......w.+.w
wwwwwwwwwwwww
