wwwwwwwwwwwww
w.....w...wgw
w.....w.w.w.w
w.........11w
w.....w..ww.w
w.+.........w
wA.w.ww...w.w
w...........w
wwwwwwwwwwwww
