wwwwwwwwwwwww
wA....w.w...w
ww..w...www.w
w...w...3...w
w...w.ww...ww
w...w.+.....w
wwwww......1w
w.........1gw
wwwwwwwwwwwww
