wwwwwwwwwwwww
w...........w
w...2.w....gw
w...........w
w.w.........w
w...........w
w+w.w..Aw...w
w...........w
wwwwwwwwwwwww
