wwwwwwwwwwwww
w...+....1.1w
w.....w...w.w
w...........w
w.w.....w...w
wA..........w
w..w..w.w...w
w..........gw
wwwwwwwwwwwww
