wwwwwwwwwwwww
wA..........w
w...+.w.....w
w...........w
w.w...w.w.2.w
w..........gw
w...........w
w...........w
wwwwwwwwwwwww
