wwwwwwwwwwwww
w...+....1..w
w...........w
w.........g.w
wA........w.w
w...........w
w.w.w.....w.w
w...........w
wwwwwwwwwwwww
