wwwwwwwwwwwww
w.......A...w
w...w...w.w.w
w...........w
w...w.......w
w..+........w
w.w.........w
wg2.........w
wwwwwwwwwwwww
