wwwwwwwwwwwww
w...........w
w.....w.w.A.w
w...........w
w.w.........w
w2.g........w
w...........w
w.........+.w
wwwwwwwwwwwww
