wwwwwwwwwwwww
w...w.......w
w..........Aw
w.......w...w
w...w.w.w.w.w
w...........w
w.3.w.www...w
wgw...+.....w
wwwwwwwwwwwww
