wwwwwwwwwwwww
w.w.....w.w.w
w.w...w.w.w.w
w.w....Aw...w
w....ww.w.w.w
w1.........gw
w...w.w.www2w
w+..w.......w
wwwwwwwwwwwww
