wwwwwwwwwwwww
w...........w
w.w.........w
w...........w
w.w....Aw.w.w
wg..........w
w...w...w..+w
w...........w
wwwwwwwwwwwww
