wwwwwwwwwwwww
w..........2w
w.w.......w+w
w.w.......w.w
www...w.w.w3w
w..........gw
www...w...w.w
w...A.....w.w
wwwwwwwwwwwww
