wwwwwwwwwwwww
w...........w
w.A.www.ww.2w
w.....w....+w
ww..w.w.....w
w...........w
w.w...w...w1w
w....g....w.w
wwwwwwwwwwwww
