wwwwwwwwwwwww
w.......1..gw
w.........w.w
w.........2.w
w.........w.w
w....A......w
w.w.w.....w.w
w+..........w
wwwwwwwwwwwww
