wwwwwwwwwwwww
w.........g.w
w.......w...w
w...........w
w.w.........w
w+..........w
w....A......w
w..........3w
wwwwwwwwwwwww
