wwwwwwwwwwwww
w..g.......1w
ww....w...w.w
w.....w.....w
w.w.w.w.w.w.w
w...........w
www.w...A...w
w.2........+w
wwwwwwwwwwwww
