wwwwwwwwwwwww
w........2g.w
w...........w
w...........w
w...w.w.w.w.w
w...+.......w
w.........w.w
w.....A.....w
wwwwwwwwwwwww
