wwwwwwwwwwwww
w......A....w
w...w.w.w.w+w
w...........w
w.....w...w.w
w.g.1.......w
w.....w.....w
w.3.........w
wwwwwwwwwwwww
