wwwwwwwwwwwww
w+..........w
w.....A.w...w
w...........w
w.w.w...w...w
w...........w
w.w.........w
w3.........gw
wwwwwwwwwwwww
