wwwwwwwwwwwww
w.A.........w
w.w.........w
w...........w
w.....w.w...w
w...........w
w+..w.....w.w
w........g.1w
wwwwwwwwwwwww
