wwwwwwwwwwwww
w..3........w
w.g.......w.w
w..3........w
w.....w.w...w
w...........w
w.....w....Aw
w.......+...w
wwwwwwwwwwwww
