wwwwwwwwwwwww
w...........w
w.w.w...w.wAw
w...........w
w.g.w.......w
w...........w
w.........w.w
w....1.....+w
wwwwwwwwwwwww
