wwwwwwwwwwwww
w...1.......w
w.wgw.w..ww.w
w.........w.w
w+w.....www.w
w1w.........w
w...w.w....ww
w.....w...A.w
wwwwwwwwwwwww
