wwwwwwwwwwwww
w.....A.....w
w...w...w..ww
w...........w
w.w.w.w.www+w
w.........w1w
wgw.w...w...w
w..2......w1w
wwwwwwwwwwwww
