wwwwwwwwwwwww
w...........w
w.+..A....w.w
w...........w
www...w.....w
w.....w.....w
w.....w.w.w.w
w.........g2w
wwwwwwwwwwwww
