wwwwwwwwwwwww
w...........w
w...........w
w.........+.w
w.w.........w
w..3.......Aw
w.......w.w.w
wg..........w
wwwwwwwwwwwww
