wwwwwwwwwwwww
w.....w.w...w
w.wwwAw.w..ww
w+..w.......w
w.w.w.....w.w
w.....w.....w
ww..w....ww3w
w.....w...g1w
wwwwwwwwwwwww
