wwwwwwwwwwwww
w+..........w
w...w.......w
w...........w
w..Aww...ww2w
w...........w
w.......w.w.w
w.........g.w
wwwwwwwwwwwww
