wwwwwwwwwwwww
w...........w
w..2w.w.....w
w.+......g..w
w.w.w.w...w.w
w...........w
w...w.......w
w.....A.....w
wwwwwwwwwwwww
