wwwwwwwwwwwww
w...w.......w
w...w..ww.w3w
w.A.......w.w
w.....w.w.w+w
w...w.......w
w.www.wg.wwww
w.w.......1.w
wwwwwwwwwwwww
