wwwwwwwwwwwww
w..........gw
w.w.w.w...w.w
w...........w
wA....w.w...w
w+..........w
w.....w.....w
w.........1.w
wwwwwwwwwwwww
