wwwwwwwwwwwww
w.+........2w
w.w..ww.w.w.w
w.........w.w
wA..www.www.w
w...w.......w
w...w.wwwgw.w
w......2w...w
wwwwwwwwwwwww
