wwwwwwwwwwwww
w.......A..+w
w.w..w..w..ww
w.w.....w...w
w1w.........w
w...........w
wg.w..w...www
w.2.........w
wwwwwwwwwwwww
