wwwwwwwwwwwww
w.....+.....w
w.A.w.......w
w...........w
w.........www
w...w..1..1.w
w.w.w.w.w.wgw
w...........w
wwwwwwwwwwwww
