wwwwwwwwwwwww
w+..........w
w.........w.w
w...........w
wA......w...w
w...........w
w.w.....wg.3w
w...........w
wwwwwwwwwwwww
