wwwwwwwwwwwww
w...........w
w.w.....w.wAw
w...........w
w.w...w.w...w
w........+..w
w.w...w.....w
w1g.........w
wwwwwwwwwwwww
