wwwwwwwwwwwww
w+........w.w
w.wwwA.ww.w.w
w...........w
w...w.w...w.w
w...........w
w1w.....w.wgw
w1..........w
wwwwwwwwwwwww
