wwwwwwwwwwwww
w........g..w
w.........w.w
w...........w
w.......w.w1w
wA..........w
w...w.......w
w+..........w
wwwwwwwwwwwww
