wwwwwwwwwwwww
w.........2.w
wg..w...w.w.w
w.........+.w
w.......w...w
w...........w
w..A..w.....w
w...........w
wwwwwwwwwwwww
