wwwwwwwwwwwww
w...........w
w.w.w.....g.w
w...........w
wAw.w.w.....w
w...........w
w.......w.w.w
w.....+.....w
wwwwwwwwwwwww
