wwwwwwwwwwwww
w...2.w.....w
w+www.w.ww..w
w.......wA..w
www....wwww.w
w.......w...w
w3..w.www.w.w
w..2g.......w
wwwwwwwwwwwww
