wwwwwwwwwwwww
w.+.........w
www.w...w...w
w...A.......w
w.ww....w.w1w
w.........1.w
w.w..ww...w.w
w.........g.w
wwwwwwwwwwwww
