wwwwwwwwwwwww
w.....+.....w
w.A...w...w.w
w...........w
w.w.......w.w
w........1..w
w.w.w.......w
w..........gw
wwwwwwwwwwwww
