wwwwwwwwwwwww
w..3w.......w
w...g.w.w.www
w..1........w
w.....w.w...w
w.+.........w
w...w...ww.Aw
w...........w
wwwwwwwwwwwww
