wwwwwwwwwwwww
w...........w
w+w.w.w.....w
w...........w
w......A..g.w
w.1.........w
w...........w
w...........w
wwwwwwwwwwwww
