wwwwwwwwwwwww
w.........3.w
w.......w.1.w
wA..........w
w...w.w.w.+.w
w...........w
w.w.w.w.g...w
w...........w
wwwwwwwwwwwww
