wwwwwwwwwwwww
w...........w
w.........wgw
w...........w
wA.....2..w.w
w...........w
w.w.........w
w.........+.w
wwwwwwwwwwwww
