wwwwwwwwwwwww
w.g.w.......w
w...w2..w.www
w...........w
w.....w.w...w
w...........w
w.....w.w...w
w....A....w+w
wwwwwwwwwwwww
