wwwwwwwwwwwww
w+....w.....w
w.wA.ww.w.w.w
w...........w
w...w....w.ww
w.......g...w
w.w.w..1w.32w
w...w.......w
wwwwwwwwwwwww
