wwwwwwwwwwwww
w....+..w.31w
w.......w...w
w...........w
w.....w.w..gw
w...........w
w.A.....w...w
w...........w
wwwwwwwwwwwww
