wwwwwwwwwwwww
w..........Aw
w...w.......w
w...........w
w.w.w.......w
w.g.........w
w2w...w.w...w
w..........+w
wwwwwwwwwwwww
