wwwwwwwwwwwww
w..........gw
w1.+..ww..w.w
w.2.w.......w
w.w.w...w...w
w.w.w.......w
w.w.w..ww.w.w
w.w.w...A.w.w
wwwwwwwwwwwww
