wwwwwwwwwwwww
w..........+w
w.....w..Aw.w
w...........w
w...........w
w.......w...w
w1g.w.w.w...w
w.2.........w
wwwwwwwwwwwww
