wwwwwwwwwwwww
w.......A...w
w.....w.....w
w.........w.w
w+....w.w.w.w
w..3........w
w.w.....w.www
w..3g.......w
wwwwwwwwwwwww
