wwwwwwwwwwwww
w...A.......w
w.....w.....w
w...........w
w2..w...w...w
w..........gw
w...w.3.....w
w+..........w
wwwwwwwwwwwww
