wwwwwwwwwwwww
w+..........w
w..Aw.ww....w
w.........w.w
w.....w.w.w.w
w..........gw
w...w...w.w3w
w........1..w
wwwwwwwwwwwww
