wwwwwwwwwwwww
w..+........w
w...........w
w..A........w
w.w.....w...w
w...........w
w.w.w...1...w
w........3g.w
wwwwwwwwwwwww
