wwwwwwwwwwwww
w..........gw
w.w.w.w.w...w
w...........w
w....A....w.w
w...........w
w1w.....w...w
w+..........w
wwwwwwwwwwwww
