wwwwwwwwwwwww
w.A........3w
w.....w.....w
w...........w
w+..w.w.....w
w.........g.w
w.....2.....w
w...........w
wwwwwwwwwwwww
