wwwwwwwwwwwww
w.w+........w
w.wwwA......w
w...........w
w...w.w...w.w
w.....w....1w
www...w...w.w
w3....w.g...w
wwwwwwwwwwwww
