wwwwwwwwwwwww
w...........w
w+......w..gw
w.......w..2w
w...w..Aw..ww
w.w.........w
w...ww....w.w
w3..........w
wwwwwwwwwwwww
