wwwwwwwwwwwww
w...........w
w...wAw.w...w
w...........w
w+..........w
w...........w
w.w.......w.w
w........g..w
wwwwwwwwwwwww
