wwwwwwwwwwwww
w3.2........w
w.w.....w...w
w..g........w
w.w...www...w
w...........w
w.www.....w.w
w+.......A..w
wwwwwwwwwwwww
