wwwwwwwwwwwww
w.A.........w
w.......w...w
w...........w
w.......w+..w
w...........w
w.....w...w.w
w........21gw
wwwwwwwwwwwww
