wwwwwwwwwwwww
w........g.2w
w.......w.w.w
w.........+.w
w.....w.....w
w...........w
w...w...w...w
wA..........w
wwwwwwwwwwwww
