wwwwwwwwwwwww
w.g.....w...w
w...www.w..1w
w...........w
w.1.......w.w
w.....A.....w
w.w.www.....w
w........+w.w
wwwwwwwwwwwww
