wwwwwwwwwwwww
wA..........w
w.w...w.w.w.w
w...........w
w.........w.w
w...........w
w..........3w
w...+......gw
wwwwwwwwwwwww
