wwwwwwwwwwwww
w...........w
w...w.w.....w
wg..........w
w.....w...w.w
w...........w
w.w....A...+w
w...........w
wwwwwwwwwwwww
