wwwwwwwwwwwww
w.w2.......gw
w.www.ww....w
w.........2.w
w.......w.w.w
w.....w.w.w.w
w.w.....+.www
w.A.w.......w
wwwwwwwwwwwww
