wwwwwwwwwwwww
w......+....w
w.w...w.....w
w3.g........w
w...........w
w...........w
w.........A.w
w...........w
wwwwwwwwwwwww
