wwwwwwwwwwwww
w+..........w
w.w.w.w.w...w
w..........Aw
w.w.....w.w.w
w...........w
w....3w...w.w
w2.g........w
wwwwwwwwwwwww
