wwwwwwwwwwwww
w..2....w...w
w.w.wwwww...w
w+..w.w.....w
w.....w....Aw
w.........w.w
w1w3....www.w
w.w.g.......w
wwwwwwwwwwwww
