wwwwwwwwwwwww
w........3..w
wgw...w...w.w
w...........w
w.w.w.A.....w
w...........w
w.......w.w.w
w..........+w
wwwwwwwwwwwww
