wwwwwwwwwwwww
w...........w
w...w+......w
w...........w
w...w...w.wAw
w.g.........w
w...w.w.w...w
w...3.......w
wwwwwwwwwwwww
