wwwwwwwwwwwww
w...........w
w..3w.......w
w...........w
w...w.w...w.w
w.....A.....w
w+....w...g.w
w...........w
wwwwwwwwwwwww
