wwwwwwwwwwwww
w.33........w
w.w..1w.....w
wgw.........w
w.w...w.w.www
w...........w
w.w...w.A.w.w
w..........+w
wwwwwwwwwwwww
