wwwwwwwwwwwww
w..A........w
w.........g.w
w...........w
w...w.......w
w...........w
w.w.w......3w
w..........+w
wwwwwwwwwwwww
