wwwwwwwwwwwww
wA..........w
w........+w.w
w...........w
w.w...w.w...w
w...........w
w...w.w.w...w
w....g...1..w
wwwwwwwwwwwww
