wwwwwwwwwwwww
wAw.......+2w
w.ww..w.ww.ww
w...........w
w.w...w.w...w
w.....w.....w
w.gw..w.www.w
w.........w3w
wwwwwwwwwwwww
