wwwwwwwwwwwww
w..+........w
w.........w.w
w...........w
wAw...w.w...w
w...........w
w.......w.w.w
w........g1.w
wwwwwwwwwwwww
