wwwwwwwwwwwww
w..........+w
www.w.w.w...w
w......A....w
w.www...w.www
w...w.w....3w
wg....w.wwwww
w.2..2......w
wwwwwwwwwwwww
