wwwwwwwwwwwww
w...........w
w...........w
w..A........w
w+w......1w.w
w...........w
w.w...w.....w
w..........gw
wwwwwwwwwwwww
