wwwwwwwwwwwww
w.A.........w
w...w.....w.w
w......3....w
w.w.w.......w
w..........gw
w.w...w.....w
w........+1.w
wwwwwwwwwwwww
