wwwwwwwwwwwww
w..........gw
w...wAw...w.w
w...........w
w.w.w.w.w...w
w........1..w
w...w.....w.w
w..+.......3w
wwwwwwwwwwwww
