wwwwwwwwwwwww
w..+........w
w.w.w.....w3w
w.........3.w
w.w.w.w.w.w.w
w..........gw
w.w.w.w.w.w.w
wA..........w
wwwwwwwwwwwww
