wwwwwwwwwwwww
w2w.........w
w+..w...w...w
w....A......w
w.ww........w
w.....w.w.wgw
w3w...www.www
w...........w
wwwwwwwwwwwww
