wwwwwwwwwwwww
w.........2gw
www...w.w.w.w
w+..........w
w.....w.....w
w...........w
w....ww....3w
w.....A.....w
wwwwwwwwwwwww
