wwwwwwwwwwwww
w..........1w
w.3.w.....w.w
w.+.........w
w.w...w.w.w.w
w...........w
w.w.wA..w.gww
w...........w
wwwwwwwwwwwww
