wwwwwwwwwwwww
w.w.A.......w
w.....www.w.w
w.......w...w
w+w.w...w.www
w.....w....3w
w.w..ww..w1.w
w.......g...w
wwwwwwwwwwwww
