wwwwwwwwwwwww
w..........+w
w.1.w3....w.w
w...........w
w.w.w.......w
w...........w
wgw.......w.w
w.......A...w
wwwwwwwwwwwww
