wwwwwwwwwwwww
w...........w
w.w.....w...w
w.....A.....w
w1......w.w.w
w..........+w
w..g......w.w
w...........w
wwwwwwwwwwwww
