wwwwwwwwwwwww
w.w......+.3w
w.w.....gwwww
w..........3w
w.w.w.w.w.www
w.......w...w
wA....w.w.w.w
w.....w.....w
wwwwwwwwwwwww
