wwwwwwwwwwwww
w.1.......+.w
w.w...w.w...w
w...........w
w.w.w.w...wAw
w..1w.......w
w...w.w.w...w
wg..........w
wwwwwwwwwwwww
