wwwwwwwwwwwww
wg3.........w
w...w...w...w
w...........w
w...w.A.w...w
w...........w
w...w...w...w
w.........+.w
wwwwwwwwwwwww
