wwwwwwwwwwwww
wA..........w
w.....w.w...w
w...........w
w.w.w...w.w.w
w..........+w
w........1w.w
w.......g...w
wwwwwwwwwwwww
