wwwwwwwwwwwww
w.......g...w
w...w.w...w.w
w...........w
w.w.w.w.....w
w...........w
w..A....w...w
w....+.....1w
wwwwwwwwwwwww
