wwwwwwwwwwwww
w...........w
w.wA......w.w
w...........w
w.w.....w...w
w..........gw
w...w.w.w.w.w
w..+...3....w
wwwwwwwwwwwww
