wwwwwwwwwwwww
w.....w...w.w
w...w....ww.w
w...........w
w.w...w.wAwww
w...g.....w.w
w3ww..w.w.w.w
w1+.........w
wwwwwwwwwwwww
