wwwwwwwwwwwww
w........g..w
w+......w...w
w...........w
w...w.......w
w...........w
w...wAw.w...w
w...........w
wwwwwwwwwwwww
