wwwwwwwwwwwww
wg..........w
w...w.w.....w
w...........w
w2w.w...w...w
w.......A...w
w.......w.+.w
w...........w
wwwwwwwwwwwww
