wwwwwwwwwwwww
w.......g..3w
w.w...w.w3w.w
w...........w
w..........+w
w...........w
w.wAw...w...w
w...........w
wwwwwwwwwwwww
