wwwwwwwwwwwww
w...w.w..3..w
w.w......ww.w
wgw.......w.w
w.w.www...w3w
w...w.w.....w
w...w.wA..w.w
w.........+.w
wwwwwwwwwwwww
