wwwwwwwwwwwww
wg..w..3w...w
ww.....ww..Aw
w.3.....w...w
w.w.w..ww.w.w
w...w.......w
www.....+.w.w
w.....w...w.w
wwwwwwwwwwwww
