wwwwwwwwwwwww
w.........3.w
wA..w...w...w
w.....w.....w
w.w......ww.w
w.w.......w.w
w+w...w.w1w.w
w........g..w
wwwwwwwwwwwww
