wwwwwwwwwwwww
wA..........w
w.........w.w
w...........w
w...w.....w.w
w........+..w
w.w.w...w...w
w....1.....gw
wwwwwwwwwwwww
