wwwwwwwwwwwww
wg..w..+w...w
w1..w.w.w.www
w.w.w.......w
w.w.w.www..ww
w.........2.w
w.w.w...A...w
w.....w.....w
wwwwwwwwwwwww
