wwwwwwwwwwwww
w......A....w
w.www.ww..w.w
w...........w
w.w.w...w.w.w
w...........w
w.......w...w
w..+.3.....gw
wwwwwwwwwwwww
