wwwwwwwwwwwww
w.....w.w...w
ww.......g1.w
w..........1w
w.w...w.www.w
w.+.....w...w
w...w.......w
w...wA......w
wwwwwwwwwwwww
