wwwwwwwwwwwww
w.......g.1.w
w.......w.w.w
w...........w
w.w.w.w.....w
w..A........w
w.w.w.w.....w
w.........+.w
wwwwwwwwwwwww
