wwwwwwwwwwwww
w..A........w
w...........w
w..........+w
w...w.......w
w...........w
w.w.w.w.w...w
w.......g.3.w
wwwwwwwwwwwww
