wwwwwwwwwwwww
w.........+2w
w.w.........w
w....A......w
w.w.w.......w
w...........w
w...w.......w
wg..........w
wwwwwwwwwwwww
