wwwwwwwwwwwww
w+.........3w
w.....w.w...w
w...........w
w...w.w.w.wgw
w...A.......w
w...w.......w
w...........w
wwwwwwwwwwwww
