wwwwwwwwwwwww
w...........w
w...w.www...w
w..+w.....A.w
w1w.w.w.....w
w3..........w
w..2.gw...w.w
w.....w.....w
wwwwwwwwwwwww
