wwwwwwwwwwwww
w3..........w
ww......w...w
w.........A.w
w.w.www.www.w
w.3.........w
w.w.......w.w
w+.....g....w
wwwwwwwwwwwww
