wwwwwwwwwwwww
w...........w
w...wA....w.w
w...........w
w...w.....wgw
w...........w
w+..........w
w...1.......w
wwwwwwwwwwwww
