wwwwwwwwwwwww
w..........gw
w.w.w.w.w.w3w
w...........w
w.A.w.w.www.w
w..........3w
w.+.ww..w...w
w...w.......w
wwwwwwwwwwwww
