wwwwwwwwwwwww
w...........w
w.www.ww....w
w...+..2....w
ww...ww.ww..w
w.........g.w
wA..w...w...w
w.w...w.....w
wwwwwwwwwwwww
