wwwwwwwwwwwww
w2w.+.......w
w.w...w.....w
w1..........w
w.g...w.w.w.w
w...........w
w.w.w.w.w.w.w
w..........Aw
wwwwwwwwwwwww
