wwwwwwwwwwwww
w...A.......w
w...w.......w
w...........w
w.w.w.w.w..3w
w...........w
w.w+..w.....w
w........3g.w
wwwwwwwwwwwww
