wwwwwwwwwwwww
w+.........gw
w...........w
w........3..w
w.w.w.......w
w...........w
w....A....w.w
w...........w
wwwwwwwwwwwww
