wwwwwwwwwwwww
w...w.......w
www.www.A...w
w...........w
w1w........ww
w...........w
w2w.g.w.w..+w
w...........w
wwwwwwwwwwwww
