wwwwwwwwwwwww
w.A+........w
w.....w...w.w
w...........w
w.....w...w.w
w.........2.w
w...w...w..gw
w...........w
wwwwwwwwwwwww
