wwwwwwwwwwwww
w2g.........w
w...w.......w
w...........w
w...w.......w
w.......A..1w
w...w...w.w.w
w.........+.w
wwwwwwwwwwwww
