wwwwwwwwwwwww
w+..........w
w.w.w.w.w..ww
w1........A.w
w...www.w.www
w.......w...w
w.w.w.w.www.w
w.3.w..g....w
wwwwwwwwwwwww
