wwwwwwwwwwwww
w3w.........w
w.w.wgw.w.w.w
w.....w.....w
w.w.w.w.w.A.w
w...........w
w.+2....w...w
w...........w
wwwwwwwwwwwww
