wwwwwwwwwwwww
w..g........w
w+w...w.w.w.w
w...........w
w2..........w
w...........w
w.....w...A.w
w...........w
wwwwwwwwwwwww
