wwwwwwwwwwwww
w...........w
w...w...wA.+w
w...........w
w.......www.w
w...........w
w...w.w...w.w
w1.g........w
wwwwwwwwwwwww
