wwwwwwwwwwwww
w...........w
w....Aw.w.w3w
w...........w
w.....w.....w
w..........gw
w+......w...w
w...........w
wwwwwwwwwwwww
