wwwwwwwwwwwww
w.........wgw
w.w..w..w.w.w
w+......w2..w
w.w.www.www.w
w.w......1..w
w.....www.www
w.A...w.....w
wwwwwwwwwwwww
