wwwwwwwwwwwww
w......2w...w
w.......w..2w
w..1w....gw.w
w+w.w.w...w.w
w...........w
w...w...w.www
w....A......w
wwwwwwwwwwwww
