wwwwwwwwwwwww
w...........w
w...w.w....gw
w.......2...w
w...w.w.w...w
w...........w
w..A..w.w.w.w
w.+.........w
wwwwwwwwwwwww
