wwwwwwwwwwwww
w.1.........w
w.w.w..ww..3w
wg..........w
w.....w.w.www
w.....A.....w
w.......w...w
w.w...w....+w
wwwwwwwwwwwww
