wwwwwwwwwwwww
w.g3........w
w.w..3..w...w
w...........w
w...w.w.w.w.w
w.....w.....w
w+.......Aw.w
w...........w
wwwwwwwwwwwww
