wwwwwwwwwwwww
w+..........w
w.w.w.w....Aw
w..3........w
w.w...w.....w
w...........w
w.g.w.......w
w...........w
wwwwwwwwwwwww
