wwwwwwwwwwwww
w....3w.....w
w.g.......w.w
w2.........+w
w.w.......w.w
w.w.........w
w.......w...w
w......A....w
wwwwwwwwwwwww
