wwwwwwwwwwwww
w...........w
w.A.....w...w
w...........w
w.w.w.......w
w...........w
w..+......wgw
w...........w
wwwwwwwwwwwww
