wwwwwwwwwwwww
w.........3.w
w.w.......w3w
w..+........w
w.w.........w
w...........w
w.w.....w..gw
w.A.........w
wwwwwwwwwwwww
