wwwwwwwwwwwww
w...........w
w.w.w......gw
w...........w
wA....w.....w
w...........w
w...w.w.....w
w....+2.....w
wwwwwwwwwwwww
