wwwwwwwwwwwww
w..g........w
w2w...w.....w
w.3....A....w
w.......w...w
w...........w
w.......w.w+w
w...........w
wwwwwwwwwwwww
