wwwwwwwwwwwww
wgw........2w
w....ww.....w
w...........w
w.w.ww......w
w......A....w
www.w....ww.w
w3....w....+w
wwwwwwwwwwwww
