wwwwwwwwwwwww
w.........A.w
w.w.........w
wg..........w
w.........w.w
w...........w
w.w.w.w.w...w
w.......+...w
wwwwwwwwwwwww
