wwwwwwwwwwwww
w.........A.w
w.....w.w...w
w...........w
w...w.w...w.w
w...........w
wg........w.w
w2...+......w
wwwwwwwwwwwww
