wwwwwwwwwwwww
w..........gw
w...........w
w....A......w
w.........w.w
w...........w
w.w.w...w..2w
w.+.........w
wwwwwwwwwwwww
