wwwwwwwwwwwww
w1...g......w
w...........w
w...........w
w...........w
w...........w
w.+.........w
w.........A.w
wwwwwwwwwwwww
