wwwwwwwwwwwww
w...........w
w...w...w.w.w
w+.....1....w
w..Aw.......w
w...........w
w1..w....gw.w
w...........w
wwwwwwwwwwwww
