wwwwwwwwwwwww
w..gw.w...w.w
w1..w...w.w.w
w1....w.....w
w...w...w.w.w
w.......w.w.w
w...........w
w+.......A..w
wwwwwwwwwwwww
