wwwwwwwwwwwww
w..........+w
wA..........w
w...........w
w.w.........w
w...........w
w.w...w.w.w.w
w..........gw
wwwwwwwwwwwww
