wwwwwwwwwwwww
w....+......w
w.A.w.......w
w...........w
w.........w.w
w...........w
w...w...w.w.w
w......3...gw
wwwwwwwwwwwww
