wwwwwwwwwwwww
w+..........w
w.w.........w
w...........w
w.w.A.......w
w...........w
w.w.w.w.w...w
w......2...gw
wwwwwwwwwwwww
