wwwwwwwwwwwww
w..........gw
w+..www.w.w.w
w.w.........w
w.w....ww...w
w..A....w...w
w.ww...ww2..w
w.w.....3...w
wwwwwwwwwwwww
