wwwwwwwwwwwww
w..........+w
w.....w.....w
w.........A.w
w...........w
w...........w
w...w.....w.w
wg3.........w
wwwwwwwwwwwww
