wwwwwwwwwwwww
w...........w
w.....w.w...w
w.A.........w
w.......w2g.w
w...........w
w.....w.....w
w.....+.....w
wwwwwwwwwwwww
