wwwwwwwwwwwww
w.w.w.....3.w
w.w.ww....wgw
w.........w.w
w.w...w.w.w.w
w...w.w.....w
ww.Awwwww.w.w
w........1+.w
wwwwwwwwwwwww
