wwwwwwwwwwwww
w.........2gw
w.w.......w.w
w...........w
w.w.......w.w
w...+.......w
wAw.......w.w
w...........w
wwwwwwwwwwwww
