wwwwwwwwwwwww
w...........w
w......A....w
w...........w
w...........w
w.........+.w
w.......w...w
w2g.........w
wwwwwwwwwwwww
