wwwwwwwwwwwww
w.+.........w
w...w......3w
w...w.......w
w..Aw......ww
w.........g.w
w.....w.w...w
w..........3w
wwwwwwwwwwwww
