wwwwwwwwwwwww
w.g..3......w
w2......w...w
w...........w
w.w.....w.w.w
w..........+w
w.w.w.A.w...w
w...........w
wwwwwwwwwwwww
