wwwwwwwwwwwww
w..........3w
w.www.w.w.w.w
w.w.......w.w
wgw.w.w...w.w
w...w.......w
w3w.ww..w.www
w.......A..+w
wwwwwwwwwwwww
