wwwwwwwwwwwww
w..........gw
w...w.w..ww.w
w...w.......w
w...www.w..2w
w...A.......w
w2w.w.www.w.w
w.......1.+.w
wwwwwwwwwwwww
