wwwwwwwwwwwww
w2g.........w
w.w.w.......w
w...........w
w.w.........w
w...........w
w.....wA...+w
w...........w
wwwwwwwwwwwww
