wwwwwwwwwwwww
w.g........+w
w.w...w.....w
w...........w
w.w...w.....w
w...........w
w.w...w..Aw.w
w...........w
wwwwwwwwwwwww
