wwwwwwwwwwwww
w........A..w
w..ww.w..ww.w
w...........w
w..ww.w.+...w
w1..........w
w.....w.....w
w...g.1...w.w
wwwwwwwwwwwww
