wwwwwwwwwwwww
w1.........gw
w.+.w.......w
w...........w
w...........w
w...........w
w....w..w...w
w......A....w
wwwwwwwwwwwww
