wwwwwwwwwwwww
wg..w.......w
w1....w.w...w
w...........w
w1..w.w....+w
w...w.......w
w...w.wAw.w.w
w...........w
wwwwwwwwwwwww
