wwwwwwwwwwwww
w.........3gw
w.w1.......2w
w+w.........w
w.w....ww.w.w
w...........w
w.......w.w.w
w.....A.....w
wwwwwwwwwwwww
