wwwwwwwwwwwww
w........A..w
w.....ww....w
w...w.w.....w
www3w.w.w...w
w...........w
wgw.....w.w.w
w.......+...w
wwwwwwwwwwwww
