wwwwwwwwwwwww
w1w3........w
wg..2....ww.w
w...........w
w.w..w...wwww
w...........w
w.w...w..w..w
w..+..w..A..w
wwwwwwwwwwwww
