wwwwwwwwwwwww
w+......w...w
w.w.wA....w.w
w...........w
w...ww..w...w
w...w.......w
w2w.w.w....ww
w.3.......g.w
wwwwwwwwwwwww
