wwwwwwwwwwwww
w.......+...w
w...w.......w
w...........w
w.w.w.w....Aw
w...........w
w.w.........w
w.1g........w
wwwwwwwwwwwww
