wwwwwwwwwwwww
w.......A...w
w.........w.w
w...........w
w.2...w.....w
w...........w
wg....1...w.w
w..........+w
wwwwwwwwwwwww
