wwwwwwwwwwwww
w......A....w
w...w......+w
w...........w
w.w.........w
w3..........w
w.w...w.....w
w.1.g.......w
wwwwwwwwwwwww
