wwwwwwwwwwwww
w.g.........w
w.w.....w.w.w
w.2.....w...w
w...w.....w.w
w.2....A....w
www.w.w...w.w
w..........+w
wwwwwwwwwwwww
