wwwwwwwwwwwww
w......A....w
w...w...w...w
w...........w
w...w.....www
w.........w.w
w.....w.3.w+w
w..g........w
wwwwwwwwwwwww
