wwwwwwwwwwwww
wA..........w
w...........w
w.....+.....w
w...w...w.w.w
w...........w
w.w...3.w.w.w
w.........g.w
wwwwwwwwwwwww
