wwwwwwwwwwwww
w........A..w
w...w.......w
w...........w
w.w.w.......w
w....g......w
w+w.w.....w.w
w...........w
wwwwwwwwwwwww
