wwwwwwwwwwwww
w...+.......w
w.w.......w.w
w...........w
w.A.......1.w
w...........w
w.....w.....w
w........g..w
wwwwwwwwwwwww
