wwwwwwwwwwwww
w.g......2..w
ww......w.w.w
w.........w.w
w.w.w.w.....w
w...........w
w.w...w.....w
w......A...+w
wwwwwwwwwwwww
