wwwwwwwwwwwww
w.......g...w
w...w.w.www.w
w.........1.w
w...A...w...w
w.........w.w
w...w.ww..w.w
w+..........w
wwwwwwwwwwwww
