wwwwwwwwwwwww
w.......A...w
w.ww.w....w+w
w...........w
w.w.w...wwwww
w.1.........w
w...wwwwwww.w
w.g........1w
wwwwwwwwwwwww
