wwwwwwwwwwwww
w..3.......3w
w.www.www.wgw
w...........w
w.....A.w.w.w
w.......w...w
w...w.....w.w
w..+.......1w
wwwwwwwwwwwww
