wwwwwwwwwwwww
w.........g3w
w.........w.w
w...........w
w...w.w.....w
w....A......w
w+w.w.....w.w
w...........w
wwwwwwwwwwwww
