wwwwwwwwwwwww
w.........A.w
w...w...w...w
w...........w
w.w.........w
w.2.........w
w.g.w.+.....w
w...........w
wwwwwwwwwwwww
