wwwwwwwwwwwww
w......1....w
w..g.2w.w...w
w...........w
www.www...w.w
w...........w
w.....w.A..+w
w.........w.w
wwwwwwwwwwwww
