wwwwwwwwwwwww
w2....w..A..w
w.w.......w.w
w.........w.w
w.w.......w.w
w1.g..w.....w
w..+www.w...w
w...........w
wwwwwwwwwwwww
