wwwwwwwwwwwww
w.........2.w
w.........+.w
w...........w
w.w.w.......w
w.....A.....w
w.2.w.w...w.w
wg..........w
wwwwwwwwwwwww
