wwwwwwwwwwwww
w.......A...w
www.ww..w.w+w
w...........w
ww.ww.w.w...w
w.......w.w.w
www.w.w.w3www
w.g...w....1w
wwwwwwwwwwwww
