wwwwwwwwwwwww
w......g.1.3w
w.w.w...w...w
w...w.......w
w.www...w.w+w
wA..........w
w.w.w.w.w.w.w
w.......w...w
wwwwwwwwwwwww
