wwwwwwwwwwwww
w..........+w
w.1.w.w.....w
w...........w
w.....wAw.w.w
w...........w
w..gw.....w.w
w...........w
wwwwwwwwwwwww
