wwwwwwwwwwwww
w..........+w
w.3.....www.w
w3......w...w
w...w...w.w.w
w........A..w
w...w...w...w
w.g.........w
wwwwwwwwwwwww
