wwwwwwwwwwwww
w3..........w
wg..w.w...w.w
w...........w
w...w...w.w.w
w..2..w....+w
w.w.........w
w.w.w...A.w.w
wwwwwwwwwwwww
