wwwwwwwwwwwww
wA..........w
w...........w
w...........w
w.........w.w
w..........+w
w...........w
w.........g.w
wwwwwwwwwwwww
