wwwwwwwwwwwww
w...........w
w.....w.g...w
w........3.+w
w.w.w.....w.w
w........3..w
wAw.....w...w
w...........w
wwwwwwwwwwwww
