wwwwwwwwwwwww
w.........+.w
w.....w.w.w.w
w...........w
w.w..3w.....w
w........A..w
wg..........w
w...........w
wwwwwwwwwwwww
