wwwwwwwwwwwww
w+..w.......w
w..2...ww.w.w
w...........w
w...wA.ww...w
w.......w...w
w.w.w.w.w.w.w
w.1.......wgw
wwwwwwwwwwwww
