wwwwwwwwwwwww
w........g..w
w.w...w.....w
w...........w
w.w........2w
w..........2w
w+..wAw.w...w
w...........w
wwwwwwwwwwwww
