wwwwwwwwwwwww
w...+.......w
w.....w.w...w
w......A....w
w...w.w.w.w.w
w...........w
w.w.w...w..2w
w.1........gw
wwwwwwwwwwwww
