wwwwwwwwwwwww
w...........w
wA..........w
w...........w
w.......w...w
w.........g.w
w......+...2w
w...........w
wwwwwwwwwwwww
