wwwwwwwwwwwww
w3..g.......w
ww......w.w.w
w...w.......w
w...w...w.w.w
w1......wAw+w
w1..w..ww.w.w
w.w.........w
wwwwwwwwwwwww
