wwwwwwwwwwwww
w...........w
w...w.......w
w...........w
wA..w.....w.w
w.......+..gw
w.....w...w1w
w...........w
wwwwwwwwwwwww
