wwwwwwwwwwwww
w...........w
wAw.....w.w.w
w...........w
w.....w.....w
w...........w
w.......1.w.w
w..+......g.w
wwwwwwwwwwwww
