wwwwwwwwwwwww
w...........w
w.w+w...w.w.w
wA..w.......w
w...w...w.w.w
w.....w....3w
w...w......gw
w.........3.w
wwwwwwwwwwwww
