wwwwwwwwwwwww
w.........+.w
w.....wA....w
w...........w
w.w...w...w.w
w.3.........w
w.wg..w...w.w
w...........w
wwwwwwwwwwwww
