wwwwwwwwwwwww
wg........3.w
ww..w.......w
w...........w
w...w.A.....w
w...........w
w.w.w.....+.w
w...........w
wwwwwwwwwwwww
