wwwwwwwwwwwww
wg.......2..w
w.w.........w
w........+..w
w.w.w.w.....w
w...........w
w...w.w.w...w
w.....A.....w
wwwwwwwwwwwww
