wwwwwwwwwwwww
w......2...3w
w.+.w.....w.w
w..........gw
wAw...w...w.w
w...........w
w.w.w.w.w.w.w
w.......w...w
wwwwwwwwwwwww
