wwwwwwwwwwwww
w...........w
w.w.......wAw
w......+....w
w.....w.w.w.w
w...........w
w.w.....w...w
wg..1.......w
wwwwwwwwwwwww
