wwwwwwwwwwwww
w...........w
w...w..A..w.w
w...........w
w.....w.....w
w2...1......w
w.+gw.w.....w
w...........w
wwwwwwwwwwwww
