wwwwwwwwwwwww
w...........w
w.2.w.A.w...w
w...w.......w
w.w.ww.....3w
w+......w.g.w
w.ww....w.w.w
w...........w
wwwwwwwwwwwww
