wwwwwwwwwwwww
w......A....w
w...........w
w..........+w
w.....w.w...w
w...........w
w.....w.....w
w3g.........w
wwwwwwwwwwwww
