wwwwwwwwwwwww
w.A.........w
w.w.w...w...w
w...........w
w.......w...w
w...........w
w...w.w.....w
w........+.gw
wwwwwwwwwwwww
