wwwwwwwwwwwww
w+g..2......w
w....ww.w...w
w.....2.....w
w...w.w.w...w
w.w.........w
w2www.....www
w..........Aw
wwwwwwwwwwwww
