wwwwwwwwwwwww
w..........gw
w...A.......w
w...........w
w.w.........w
w...........w
w+..w...w.w1w
w...........w
wwwwwwwwwwwww
