wwwwwwwwwwwww
w..........+w
w1wwwgw....ww
w.2...w.....w
w.w...w....ww
w.....w.....w
w.w.......w.w
w.....w...A.w
wwwwwwwwwwwww
