wwwwwwwwwwwww
w+..........w
w.w...w.....w
w...........w
w...A.w.3...w
w..........1w
w...w.....w.w
w..........gw
wwwwwwwwwwwww
