wwwwwwwwwwwww
w..........+w
w.w.w.....w2w
w...........w
w...........w
w....A......w
wg......w...w
w...........w
wwwwwwwwwwwww
