wwwwwwwwwwwww
w1g.........w
w3..w1..w...w
w...........w
w.w.w...w.www
w...........w
w...w...A...w
w.w........+w
wwwwwwwwwwwww
