wwwwwwwwwwwww
w......g....w
w.........www
w.....+.....w
w..w......w3w
w..........2w
wAw.ww..ww..w
w...........w
wwwwwwwwwwwww
