wwwwwwwwwwwww
w.......w...w
w.w1w..ww..1w
w.w........gw
w.w.w..Aw...w
w...........w
w....ww.....w
w..+..w...w.w
wwwwwwwwwwwww
