wwwwwwwwwwwww
w........+w.w
w...www.....w
w...w.......w
w...w..Aw.w.w
w...........w
w2w.w...w...w
w.g...2.w.w.w
wwwwwwwwwwwww
