wwwwwwwwwwwww
w.........+.w
w.....w.....w
w..........1w
wg..w.w.w...w
w...........w
w...w...w...w
w......A....w
wwwwwwwwwwwww
