wwwwwwwwwwwww
w.+.........w
w.w.........w
w..A........w
w.w.w......1w
w...........w
w.w.w.w.wgw2w
w...........w
wwwwwwwwwwwww
