wwwwwwwwwwwww
w...........w
w..g........w
w...........w
w...w...w.A.w
w...........w
w.w.w.......w
w..1+.......w
wwwwwwwwwwwww
