wwwwwwwwwwwww
w.........3gw
w.w.....w.w.w
w..........3w
w.........w.w
w...........w
w..A........w
w+..........w
wwwwwwwwwwwww
