wwwwwwwwwwwww
w...........w
wA......w...w
w...........w
w...w.w.....w
w..........gw
w...w.w.....w
w.......+...w
wwwwwwwwwwwww
