wwwwwwwwwwwww
w...........w
w...w.w....+w
w...........w
w....Aw.....w
w...........w
w.w.....w...w
wg3.........w
wwwwwwwwwwwww
