wwwwwwwwwwwww
w....Aw.....w
www........+w
w...........w
w...w.w.w.w.w
w...........w
w...w.w..gw.w
w.13........w
wwwwwwwwwwwww
