wwwwwwwwwwwww
w...w.....g+w
w.w...w.w...w
w.....w.....w
w....ww..ww.w
wA..........w
w...w...w...w
w.........21w
wwwwwwwwwwwww
