wwwwwwwwwwwww
w...A.......w
w.w.....w...w
w...........w
w...........w
w...........w
w.......w..+w
w........g2.w
wwwwwwwwwwwww
