wwwwwwwwwwwww
w.........g.w
w..3........w
w.......2...w
w.w.w.w..ww.w
w.w..A......w
w...w.w...w.w
w..+....w...w
wwwwwwwwwwwww
