wwwwwwwwwwwww
w..A........w
w.....w.....w
w...........w
w.....w....+w
w...........w
w..........2w
w........g..w
wwwwwwwwwwwww
