wwwwwwwwwwwww
w.......w.13w
www.www.w+..w
w.w.....A...w
w.w...ww.w..w
w.....w.....w
w.wg..w.....w
w.......w.w.w
wwwwwwwwwwwww
