wwwwwwwwwwwww
w........2..w
w...w...wg.3w
w...........w
w.....w.....w
w...........w
wA......w.w.w
w....+......w
wwwwwwwwwwwww
