wwwwwwwwwwwww
w...........w
w...2.w...w.w
w3....w.....w
w.gw..w...w.w
w.......w...w
w.www.w.wwA.w
w+......w...w
wwwwwwwwwwwww
