wwwwwwwwwwwww
w1....w...w.w
w...........w
w..+........w
w.....w...wgw
w.....A.....w
w...w...1.w.w
w...........w
wwwwwwwwwwwww
