wwwwwwwwwwwww
w..........Aw
w...w.......w
w....+......w
w.3...w.w.w.w
w...........w
wg........w.w
w...........w
wwwwwwwwwwwww
