wwwwwwwwwwwww
w.g.......w.w
w.w...www1w.w
w..........1w
w.w........+w
w.....w.....w
w.w.w.wAww..w
w.......w...w
wwwwwwwwwwwww
