wwwwwwwwwwwww
w..........gw
w.....w..2w.w
w...........w
w.A.........w
w...........w
w...w.w.....w
w+..........w
wwwwwwwwwwwww
