wwwwwwwwwwwww
w....A.....+w
w...w.....w.w
w..3........w
wg......w.w.w
w...........w
w.w.w.w.w...w
w...........w
wwwwwwwwwwwww
