wwwwwwwwwwwww
w........3.2w
w...w...w1w.w
w..........+w
wA..wwwww...w
w.w.w....g..w
w.wwww..www.w
w...........w
wwwwwwwwwwwww
