wwwwwwwwwwwww
w+..........w
w.ww....w.w.w
w.....w...w.w
w.....A.....w
w...........w
w.w...w.....w
w.......wg2.w
wwwwwwwwwwwww
