wwwwwwwwwwwww
wA..w.......w
w...w.w.w.w.w
w.w.........w
w.ww....w..ww
w..........gw
w.......w...w
w+..w.w.w2.1w
wwwwwwwwwwwww
