wwwwwwwwwwwww
w.....w..3..w
w.w.....g...w
w.w.....w...w
w.......w+w.w
w.w.........w
w.w.w.....w.w
w.A.........w
wwwwwwwwwwwww
