wwwwwwwwwwwww
wA..........w
w...........w
w.........+.w
w.w.........w
w........1..w
w.....w.wgw.w
w...........w
wwwwwwwwwwwww
