wwwwwwwwwwwww
w+..w.......w
w.w.A.www.w.w
w.....w...w.w
w.w...w.www.w
w........2..w
w.....w..2www
w.....w..g..w
wwwwwwwwwwwww
