wwwwwwwwwwwww
w....+......w
w.w.....13..w
w...........w
w.w.w...w.g.w
w...........w
w.......w...w
w...A.......w
wwwwwwwwwwwww
