wwwwwwwwwwwww
w.3.........w
w...w.w...w.w
w...wA....w.w
w.w.....w.www
w.......w3..w
w.w.w.w...w.w
wg......w+..w
wwwwwwwwwwwww
