wwwwwwwwwwwww
w.w.........w
w+wwwwwAw.w.w
w2........w.w
wwww..w...w.w
w...........w
w.3.....w..gw
w..1w...w...w
wwwwwwwwwwwww
