wwwwwwwwwwwww
w.......+...w
w.....w....Aw
w...........w
w.....w.....w
w...........w
w2w3w.w.....w
w.g.........w
wwwwwwwwwwwww
