wwwwwwwwwwwww
wA..w...g...w
w.w.w...w.www
w.....w.....w
w...www3.+w.w
w.........w.w
w....ww...www
w..........3w
wwwwwwwwwwwww
