wwwwwwwwwwwww
w..A........w
w.w.w.....w.w
w...........w
w...w.....w.w
w+.....1....w
w.....w....gw
w.2.........w
wwwwwwwwwwwww
