wwwwwwwwwwwww
w.......w...w
w.wA..w...w.w
w+..........w
w.w...ww..w.w
w.....w.....w
w.....w...w.w
w.......1.g2w
wwwwwwwwwwwww
