wwwwwwwwwwwww
w...1.......w
w.+gw..ww...w
w..3........w
w.....w.w...w
w.....w.....w
w.w.www....Aw
w.........w.w
wwwwwwwwwwwww
