wwwwwwwwwwwww
w..........gw
w...w..2..w2w
w...........w
w...w.....w.w
w...........w
w.A.........w
w....+......w
wwwwwwwwwwwww
