wwwwwwwwwwwww
w...........w
w.w.......w.w
w+..........w
w.w.w.w...wAw
w...........w
w.w.......w.w
w2..g.......w
wwwwwwwwwwwww
