wwwwwwwwwwwww
w...g.......w
w2........w.w
w...w.......w
w.w.w.www.w.w
w.....w.....w
w+w...w....Aw
w...........w
wwwwwwwwwwwww
