wwwwwwwwwwwww
w+..........w
w...........w
w.........33w
w.....w..ww.w
w...w.w.....w
w...w.w...wgw
w...A.w.....w
wwwwwwwwwwwww
