wwwwwwwwwwwww
w..+......11w
w.w...w.www.w
w.......w...w
w.w..w.ww.w.w
wA........w.w
w.www.ww..w.w
w.w.....1.g.w
wwwwwwwwwwwww
