wwwwwwwwwwwww
w2..........w
w.....w.w.w.w
w..g.....A..w
ww...ww..wwww
w...........w
w.w..w....www
w.1........+w
wwwwwwwwwwwww
