wwwwwwwwwwwww
w.........A.w
w.w...www...w
w.w.........w
w.w.....w...w
w2......w...w
w+wwww..w..ww
w.3.g.......w
wwwwwwwwwwwww
