wwwwwwwwwwwww
w.+.........w
w.w.w.w.....w
w..........1w
w...w.w.w...w
w...........w
w...w.....g.w
w..A........w
wwwwwwwwwwwww
