wwwwwwwwwwwww
w......A....w
www.w.....w.w
w...........w
w........ww.w
w...........w
wgw......3w+w
w...........w
wwwwwwwwwwwww
