wwwwwwwwwwwww
wA..........w
w...w.......w
w...........w
w...w.w.w.wgw
w...........w
w..+w.w....2w
w...........w
wwwwwwwwwwwww
