wwwwwwwwwwwww
w.......w...w
wg..ww......w
w.3....+....w
w.w.w.w.....w
w...w.w...A.w
w.w.........w
w.1.......w.w
wwwwwwwwwwwww
