wwwwwwwwwwwww
wA..........w
ww..w...w.g.w
w...........w
w.www.www..2w
w...........w
w.wwww..w2..w
w..........+w
wwwwwwwwwwwww
