wwwwwwwwwwwww
w22.g.....w.w
w...w.www.w.w
w.w.........w
w.w...w.....w
w.........w.w
w.......A.w.w
w.+.........w
wwwwwwwwwwwww
