wwwwwwwwwwwww
w....+..w...w
w...w.....w.w
wAw.........w
w.w.w....1.ww
w...........w
w.....w.wgw.w
w.w.......w2w
wwwwwwwwwwwww
