wwwwwwwwwwwww
wA..........w
w..w........w
w...........w
w..ww...www+w
w.........3.w
w...w.w.w...w
w.........g.w
wwwwwwwwwwwww
