wwwwwwwwwwwww
w.w.+.....w.w
w.w...w.w.w.w
w.w......g.2w
w.w..w..w.w1w
w...........w
www.w.w...w.w
w..Aw.w.....w
wwwwwwwwwwwww
