wwwwwwwwwwwww
w.........1.w
w.w.w.w.....w
wA..........w
w...........w
w..........+w
w...w...w.w.w
w..........gw
wwwwwwwwwwwww
