wwwwwwwwwwwww
w2....+.....w
w.w.w.w...w.w
w.g.........w
w...w......ww
w...........w
w...w...w.w.w
w........A..w
wwwwwwwwwwwww
