wwwwwwwwwwwww
w...........w
w...w3...ww.w
w..Aw.......w
w...w.w....gw
w...........w
w+w..3w.w.w.w
w.......w.w.w
wwwwwwwwwwwww
