wwwwwwwwwwwww
w.........g.w
w...w.....w.w
w..A........w
w.....w.....w
w.w.........w
www.www...13w
w.+.........w
wwwwwwwwwwwww
