wwwwwwwwwwwww
w..........+w
w.....w.wA..w
w...........w
w...........w
w...........w
w2wgw...w...w
w3..........w
wwwwwwwwwwwww
