wwwwwwwwwwwww
w...........w
w.......w.A.w
w..........+w
w.......w...w
w...........w
wgw.w...w.w.w
w...........w
wwwwwwwwwwwww
