wwwwwwwwwwwww
w.A.........w
w...........w
w+..........w
w...w.w.w...w
w...........w
w.w.w...2...w
w.........g.w
wwwwwwwwwwwww
