wwwwwwwwwwwww
w.w.w......2w
w.w.w.www.w.w
w...........w
w.w.A.ww..w.w
w+..w.w....gw
w.w.w...w.www
w...w......2w
wwwwwwwwwwwww
