wwwwwwwwwwwww
w...........w
w.........g.w
w...+.....3.w
w.......w.w.w
w...........w
w.......w.w.w
w..A........w
wwwwwwwwwwwww
