wwwwwwwwwwwww
w..........Aw
w.w...w.....w
w...........w
w.w.........w
w3..........w
w.w...w.....w
w.g..+......w
wwwwwwwwwwwww
