wwwwwwwwwwwww
w...........w
ww..w...g.w.w
w.A.........w
w...........w
w.........w.w
w.w.....w.w.w
w......+11..w
wwwwwwwwwwwww
