wwwwwwwwwwwww
w........A..w
w.....w.....w
w...........w
w...w.w.w..+w
w...........w
w...w.w.w.w.w
wg...1......w
wwwwwwwwwwwww
