wwwwwwwwwwwww
w...........w
wAw+w.w.w...w
w...........w
w...www.....w
w.........21w
ww..w.....w3w
w..........gw
wwwwwwwwwwwww
