wwwwwwwwwwwww
w.......+..1w
w...w......gw
w...........w
w...w...w.w.w
w...........w
wA..........w
w...........w
wwwwwwwwwwwww
