wwwwwwwwwwwww
w...w.w+...1w
w.....w.www.w
w.w.....w.w.w
w.w...w.w.w.w
w.A.....w...w
w...w.w...wgw
w........1w.w
wwwwwwwwwwwww
