wwwwwwwwwwwww
w..A........w
w.........wgw
w...........w
w.........w.w
w+..........w
w.w.w.w...w.w
w...........w
wwwwwwwwwwwww
