wwwwwwwwwwwww
w.w...w..1w.w
w.w.w.w..gw1w
w.w.........w
w...w.w.w.w.w
w..........+w
w..ww...w...w
w.A.........w
wwwwwwwwwwwww
