wwwwwwwwwwwww
w.......3..gw
w...........w
w...........w
wAw.w.......w
w...........w
w.w.w.......w
w.........+.w
wwwwwwwwwwwww
