wwwwwwwwwwwww
w..Aw.w.....w
w.w.w.......w
w...........w
w...w.www.w.w
w...........w
w+..w.w1w2..w
w.....w...g1w
wwwwwwwwwwwww
