wwwwwwwwwwwww
w.....w.....w
w.w.w.w..g..w
w.......w.1.w
w.......w.w.w
w.....w.....w
w+A..ww.ww..w
w.........1.w
wwwwwwwwwwwww
