wwwwwwwwwwwww
w.w........Aw
w+..w.www.w.w
w.2.w.......w
w...w.......w
w3.....g....w
w.w...w.w..ww
w.......w...w
wwwwwwwwwwwww
