wwwwwwwwwwwww
w.+.....w...w
w.www...w.w.w
w....A......w
w.w...w.w..2w
w...........w
w3wwww..w.w.w
w.........wgw
wwwwwwwwwwwww
