wwwwwwwwwwwww
w......+....w
w...wAw.w...w
w...........w
w.w...w.w.w.w
w1..........w
w.w........ww
w...w.w...g.w
wwwwwwwwwwwww
