wwwwwwwwwwwww
w...........w
wA..w.......w
w...........w
w...w.w.w.w.w
w.......+...w
w.w...w.w.w.w
w......2...gw
wwwwwwwwwwwww
