wwwwwwwwwwwww
w......A....w
w...ww....w.w
w...........w
w.w.w......ww
w.........+.w
w.w..ww.w.w1w
wg......w3..w
wwwwwwwwwwwww
