wwwwwwwwwwwww
w.....w.....w
w.w.w.......w
w11.w......+w
w...w.w.w...w
w.....wA....w
wgw...w.w...w
w...........w
wwwwwwwwwwwww
