wwwwwwwwwwwww
w.........g2w
w...w.......w
w...........w
w.A.....w.w.w
w...........w
w+..w.w.....w
w...........w
wwwwwwwwwwwww
