wwwwwwwwwwwww
w....g......w
w+......w...w
w.3.........w
w........Aw.w
w...3.......w
w.....w.w...w
w...........w
wwwwwwwwwwwww
