wwwwwwwwwwwww
w.......w...w
wA....w.w...w
w.........w.w
ww..w.w...w.w
w...w...w.w.w
w+.ww.w.w.w1w
w.....1..g.2w
wwwwwwwwwwwww
