wwwwwwwwwwwww
w...........w
w.....w...g.w
wA..........w
w.........2.w
w...........w
w...w.w.....w
w+..........w
wwwwwwwwwwwww
