wwwwwwwwwwwww
w.w.......+.w
w.w.w...ww..w
w.A...w.1...w
w.www.w..wwww
w...........w
w.w.w.ww.w.ww
w...w...g3..w
wwwwwwwwwwwww
