wwwwwwwwwwwww
w..........gw
w...w...w...w
w......+....w
w.w...w.....w
w...........w
w.....w.....w
w.A.........w
wwwwwwwwwwwww
