wwwwwwwwwwwww
w..+..wA....w
w...w.w.....w
w...........w
w1www...w...w
w...........w
w.w.......w1w
w.........g.w
wwwwwwwwwwwww
