wwwwwwwwwwwww
w+..........w
w.....w...w.w
w..........gw
w.wA..w...w.w
w...........w
w.w.......w2w
w...........w
wwwwwwwwwwwww
