wwwwwwwwwwwww
w.2......3..w
w..ww.www...w
wA........3.w
ww...ww.w.w.w
w.......w...w
www.www.w.gww
w...w...w+..w
wwwwwwwwwwwww
