wwwwwwwwwwwww
wg..........w
w.ww....w.w.w
w.w.....A...w
w.w.w.w.www.w
w.......w...w
w.w..ww.....w
w2w..11..+w.w
wwwwwwwwwwwww
