wwwwwwwwwwwww
w...........w
w.w...w.w.g2w
w...........w
wA....w.....w
w...........w
w.w.........w
w.+.........w
wwwwwwwwwwwww
