wwwwwwwwwwwww
w.A.........w
w...w...w..ww
w...w.......w
w.....w.w..gw
w...........w
w.w.w.ww...2w
w+.........1w
wwwwwwwwwwwww
