wwwwwwwwwwwww
w...........w
w.........+.w
w.A.........w
w.w.w.....w.w
w...........w
w...w.w..gw.w
w...........w
wwwwwwwwwwwww
