wwwwwwwwwwwww
w..g........w
w...w.w..Aw.w
w...........w
w.w.w...www.w
w.w.........w
w..+...ww..ww
w.2.......2.w
wwwwwwwwwwwww
