wwwwwwwwwwwww
w..1...+....w
w...w.....w.w
w...........w
w...w.w...w.w
wg....A.....w
w...w.....w2w
w...........w
wwwwwwwwwwwww
