wwwwwwwwwwwww
w.3.........w
w.www.w.....w
w3g........Aw
ww..........w
w...w...w...w
ww1ww.wwwww.w
w+..........w
wwwwwwwwwwwww
