wwwwwwwwwwwww
w...........w
w..A..w.wwwww
w.....w.w...w
w+w.w...w.w.w
w.........g.w
w....ww.....w
w1w......1..w
wwwwwwwwwwwww
