wwwwwwwwwwwww
w....A......w
w...w.w.w...w
w...........w
w.........w.w
w+..........w
w.w.....w..gw
w...........w
wwwwwwwwwwwww
