wwwwwwwwwwwww
w.w.......13w
w.w...w.w.+.w
w.....w.....w
w...w...w.www
w.....A...w.w
w...w.w.....w
w.g...w.....w
wwwwwwwwwwwww
