wwwwwwwwwwwww
w...........w
w.1..www.wwgw
w...........w
w...w.w.ww.ww
w2..........w
w....Aw..w..w
w+..........w
wwwwwwwwwwwww
