wwwwwwwwwwwww
w3..........w
w...w...wAw.w
w.......w...w
w...w...w...w
w......+....w
w..2w...w.w.w
w.g.........w
wwwwwwwwwwwww
