wwwwwwwwwwwww
w+..A.......w
w.........w.w
w...........w
w.........w.w
w...........w
w.w.......wgw
w......1....w
wwwwwwwwwwwww
