wwwwwwwwwwwww
w.+.........w
w...w...w...w
w.......2...w
w.....w....gw
w..A........w
w.....w.....w
w...........w
wwwwwwwwwwwww
