wwwwwwwwwwwww
w..........gw
w.w.w...2..3w
wA..........w
w.w.w.......w
w...........w
w...w.......w
w.....+.....w
wwwwwwwwwwwww
