wwwwwwwwwwwww
w....g....3.w
wwwww.www2w.w
w......+....w
w.w.w...w...w
w...........w
w.www.....w.w
wA..........w
wwwwwwwwwwwww
