wwwwwwwwwwwww
w..........3w
w+..w...w...w
w...........w
w.w...A.w...w
w.......w...w
w.2.....w.w.w
w..........gw
wwwwwwwwwwwww
