wwwwwwwwwwwww
w..3........w
w..gw.w.w.w.w
w+..........w
w.........w.w
w...........w
w...w.......w
w........A..w
wwwwwwwwwwwww
