wwwwwwwwwwwww
w........+..w
w.ww......w.w
w.......w2..w
wAwwww....w.w
w.......w.wgw
w.w.w.w.w.2.w
w.w........3w
wwwwwwwwwwwww
