wwwwwwwwwwwww
w.+.....w...w
w.w.w.w.www.w
w.....A.....w
w...w.w.1ww.w
w..1..w.....w
ww..w...w.wgw
w...........w
wwwwwwwwwwwww
