wwwwwwwwwwwww
w2.......g..w
w.w.....w..ww
w...........w
w.w.....w...w
w+......1.w.w
www...A.w.w.w
w...........w
wwwwwwwwwwwww
