wwwwwwwwwwwww
w......A....w
w.....w...w.w
w..+........w
w...w.w...w.w
w...3.......w
w.www...www.w
w3..w.....wgw
wwwwwwwwwwwww
