wwwwwwwwwwwww
w.+.......wgw
w...w.w.w.w1w
w.........3.w
w...w.w...w.w
w...........w
w.w...w.w.w.w
wA..........w
wwwwwwwwwwwww
