wwwwwwwwwwwww
w...........w
w.www.w....3w
w........+.3w
w..Aw.w.w.w.w
w.........w.w
w.w.........w
w......g....w
wwwwwwwwwwwww
