wwwwwwwwwwwww
w+..........w
w.w........Aw
w...........w
w.w...w.w...w
w.1.........w
w.....w.....w
wg..........w
wwwwwwwwwwwww
