wwwwwwwwwwwww
w...3.......w
w...w...w.w.w
w...........w
w.w........Aw
wg..........w
w.w.....w...w
w+..........w
wwwwwwwwwwwww
