wwwwwwwwwwwww
w...........w
w.A.w.......w
w...w.......w
w...w...w...w
w..........+w
w.....w.w..1w
w......g...3w
wwwwwwwwwwwww
