wwwwwwwwwwwww
w.A......+..w
ww....w.www2w
w...........w
w.......www.w
w......g..w.w
w.www....ww.w
w...2.......w
wwwwwwwwwwwww
