wwwwwwwwwwwww
w.....w.w...w
w.w..ww..3wgw
w..A..w.....w
w.w.......w.w
w.........1.w
w...w.w..wwww
w......+....w
wwwwwwwwwwwww
