wwwwwwwwwwwww
w..........gw
w.w..Aw.....w
w...........w
w.w.w.w.....w
w...........w
w3w...w.....w
w.+.........w
wwwwwwwwwwwww
