wwwwwwwwwwwww
w.g.........w
w1....w...w.w
w.2.........w
w.....w.....w
w...........w
w.....w.wA..w
w+..........w
wwwwwwwwwwwww
