wwwwwwwwwwwww
w.....w....gw
w...w...w.w3w
w...........w
w.+.wA..w.w.w
w...........w
w...w....1w.w
w...........w
wwwwwwwwwwwww
