wwwwwwwwwwwww
w2........g.w
w.w.w.w...w.w
w1..........w
w.w.w.w.w...w
w.......A...w
w.w.ww......w
w+......w.w.w
wwwwwwwwwwwww
