wwwwwwwwwwwww
w........A..w
w.w...w.w...w
w...........w
w.w.....w...w
w...........w
wgw.w.......w
w.3+........w
wwwwwwwwwwwww
