wwwwwwwwwwwww
w...g.......w
w.w3w.......w
w...........w
w...w...w.w+w
w......A....w
w.w.w...w...w
w...........w
wwwwwwwwwwwww
