wwwwwwwwwwwww
w2..........w
w.w.w...w.g.w
w2..........w
w.w...A.w.w.w
w+2.......w.w
w...w...w.w.w
w...........w
wwwwwwwwwwwww
