wwwwwwwwwwwww
w......2..g.w
w.w.w.w.w.w.w
w...........w
w.....w.w...w
w...........w
w.+...w.....w
w....A......w
wwwwwwwwwwwww
