wwwwwwwwwwwww
w...........w
w.w.....wgw.w
w...........w
w.w....+w...w
w...........w
wA..w.....w.w
w...........w
wwwwwwwwwwwww
