wwwwwwwwwwwww
w..........+w
w.w.....w...w
w...........w
w.w.....wA..w
w...........w
w.w.w.......w
w3g.........w
wwwwwwwwwwwww
