wwwwwwwwwwwww
w+w3....w...w
w.....w...w.w
w........1..w
ww........w.w
wA..w.....w.w
w...w.w...www
w.....w....gw
wwwwwwwwwwwww
