wwwwwwwwwwwww
wA..........w
w...w.w.w2w.w
w.w.w.......w
w.www.wg..w.w
w.w...+.....w
w.w.w.w.w.w.w
w........3.3w
wwwwwwwwwwwww
