wwwwwwwwwwwww
w..+........w
w.w.......w.w
w...........w
w.w.....w.wAw
w...........w
wgw.........w
w...........w
wwwwwwwwwwwww
