wwwwwwwwwwwww
w...........w
w.A.+.......w
w...........w
w.........w.w
w...........w
w.w.w.....w1w
w.........g.w
wwwwwwwwwwwww
