wwwwwwwwwwwww
w.w.......w.w
w.w...w....Aw
w...........w
ww.ww.w...w.w
w2.......+..w
w.....w...w.w
wg3.w.......w
wwwwwwwwwwwww
