wwwwwwwwwwwww
w....g......w
w...........w
w...........w
w..+........w
w...........w
w.w.......w.w
w.......A...w
wwwwwwwwwwwww
