wwwwwwwwwwwww
wg...2......w
w...w.w...w.w
w.........+.w
w.2.....w.w.w
w..........Aw
w.......w...w
w...........w
wwwwwwwwwwwww
