wwwwwwwwwwwww
w.........3gw
w...w.w.....w
w...........w
w.......w.w.w
w.....+....3w
wA..w.......w
w...........w
wwwwwwwwwwwww
