wwwwwwwwwwwww
w.........w.w
w...w.w.w.1.w
w.....w.w.w.w
wA......w...w
w.....w...g.w
w...w...w.w.w
w..+.......2w
wwwwwwwwwwwww
