wwwwwwwwwwwww
w2..........w
w...w.w.....w
w..3........w
w.w.w.w.w..Aw
w+w.........w
w.ww....w.w.w
w.g.......w.w
wwwwwwwwwwwww
