wwwwwwwwwwwww
w...........w
w.w...w.wA.+w
w...........w
w.......w...w
w...........w
w.....w.....w
w.g.........w
wwwwwwwwwwwww
