wwwwwwwwwwwww
w...........w
w.w....ww.wAw
w2.....+....w
www.ww..w...w
w2......w...w
w.w1..www...w
w..g..w.....w
wwwwwwwwwwwww
