wwwwwwwwwwwww
w..g..+.....w
w.....www.w.w
w.w..1......w
www..ww...w.w
w...........w
w.w...w.wA..w
w3..........w
wwwwwwwwwwwww
