wwwwwwwwwwwww
w.2........gw
w1.ww...w...w
w...........w
w...w..ww...w
w....A....w.w
w+..........w
w.....w.....w
wwwwwwwwwwwww
