wwwwwwwwwwwww
w...........w
w..........Aw
w...........w
w...w.w.....w
w........+..w
w.w.w.w...w.w
w1...g......w
wwwwwwwwwwwww
