wwwwwwwwwwwww
w+..........w
w.....w...w.w
w...........w
w.w...w.w...w
w...........w
w....A..w...w
w..........gw
wwwwwwwwwwwww
