wwwwwwwwwwwww
w..........+w
w.w...w..w.ww
w.g.........w
w.w.2ww..w.ww
w..3......A.w
w.w...w..wwww
w...........w
wwwwwwwwwwwww
