wwwwwwwwwwwww
w.3.2.....+.w
w.......w..ww
w...........w
w.g.w.w.A...w
w...........w
w.w.w.......w
w...........w
wwwwwwwwwwwww
