wwwwwwwwwwwww
w........gw.w
w.w.w.w.w...w
wA..........w
w.....w.w...w
w.........3.w
w...w...w1..w
w..+.......2w
wwwwwwwwwwwww
