wwwwwwwwwwwww
w....3......w
w.g2....w...w
w...........w
w+w.w.....www
w...........w
w.....w.A...w
w...........w
wwwwwwwwwwwww
