wwwwwwwwwwwww
w+.........1w
w.....w.w...w
w.......w..3w
w.....w.w.wgw
w...w.......w
w.w.w.w.wwwww
w.A.........w
wwwwwwwwwwwww
