wwwwwwwwwwwww
w+..........w
w.w.w3....w.w
w...........w
w..A....w...w
w...........w
w...w...w.w.w
w..........gw
wwwwwwwwwwwww
