wwwwwwwwwwwww
w...........w
w...wA......w
w...........w
w.w.w.....w.w
w...........w
w...w.w.w+wgw
w........3..w
wwwwwwwwwwwww
