wwwwwwwwwwwww
w...........w
w.g.w.......w
w..........Aw
w.w.........w
w......+....w
w.w.....w...w
w3..........w
wwwwwwwwwwwww
