wwwwwwwwwwwww
w.......A...w
w.w...www...w
w...........w
w.w...www...w
w...g.......w
w3..w....ww.w
w..1...+..w.w
wwwwwwwwwwwww
