wwwwwwwwwwwww
w.+.....1...w
w.....w.w...w
w1..........w
w.w.www...w.w
w.....wA..w.w
w.....w.w.www
w.w........gw
wwwwwwwwwwwww
