wwwwwwwwwwwww
w...........w
w1w..+w.w.w.w
w...........w
w.....wA....w
w...........w
wg..w.......w
w...........w
wwwwwwwwwwwww
