wwwwwwwwwwwww
wA........+.w
w...........w
w...........w
w...w.w.w...w
w...........w
w.w.w.w.g.w.w
w..........1w
wwwwwwwwwwwww
