wwwwwwwwwwwww
w.....A.....w
w.w.........w
w..........+w
w.....w.w...w
wg..........w
w3....w.w.w2w
w...........w
wwwwwwwwwwwww
