wwwwwwwwwwwww
w...........w
w.w...w.w.w.w
w..........gw
w...A...w...w
w+..........w
w.w.w...w...w
w..........1w
wwwwwwwwwwwww
