wwwwwwwwwwwww
w...w.A.....w
w3......w.w.w
w.w........+w
w.ww..www.w.w
w.......w...w
w2w.w...w.w.w
w..g.......1w
wwwwwwwwwwwww
