wwwwwwwwwwwww
wA..........w
w.......w...w
w...........w
w...w...w...w
w...+.......w
w...w...w...w
w..........gw
wwwwwwwwwwwww
