wwwwwwwwwwwww
w...w.......w
w.w.w.w.....w
w...........w
w.A.......www
w..........gw
w...w.w.3...w
w...+.......w
wwwwwwwwwwwww
