wwwwwwwwwwwww
w.........A.w
w.....w...w.w
w2..........w
w...w.......w
w...........w
wgw.w.w.w...w
w.2.....+...w
wwwwwwwwwwwww
