wwwwwwwwwwwww
w...........w
w.....w.w.w.w
w.A.......w.w
w.w........1w
w..........gw
w.w.w.......w
w+........2.w
wwwwwwwwwwwww
