wwwwwwwwwwwww
w+......A...w
w.w..w..w.w.w
w...........w
w.w....2....w
w...........w
w.w...w.ww..w
w.wg3.w.....w
wwwwwwwwwwwww
