wwwwwwwwwwwww
wA......w...w
w.ww....w.www
w..........gw
w........ww.w
w......+..w.w
w...www...w.w
w...w..23.w.w
wwwwwwwwwwwww
