wwwwwwwwwwwww
w.......1gw.w
w......w.ww3w
w..........3w
w.w.w.w.www.w
w+..w.......w
wwwAw.w.ww.ww
w.....w.....w
wwwwwwwwwwwww
