wwwwwwwwwwwww
w+........1.w
www...www.w.w
w.......g...w
w.w.......w.w
wA........w2w
w.w.w.w.www1w
w...........w
wwwwwwwwwwwww
