wwwwwwwwwwwww
w.A.......3.w
w.w...w+....w
w...........w
w.w...w...w.w
w...........w
w...w...wg..w
w...........w
wwwwwwwwwwwww
