wwwwwwwwwwwww
w.+.........w
w...A.w...1.w
w...........w
w.w.w.w.....w
w...........w
w...w.......w
w.........g1w
wwwwwwwwwwwww
