wwwwwwwwwwwww
w....+......w
w...w.w.....w
w.A........3w
w.........w.w
w...........w
w.....w...w1w
w..........gw
wwwwwwwwwwwww
