wwwwwwwwwwwww
w.......2...w
w.w...w..w..w
w...w.....g.w
w.....w...w1w
w.........w.w
w+..wA..w.w.w
w...........w
wwwwwwwwwwwww
