wwwwwwwwwwwww
w...w.....g.w
ww......ww..w
w..3........w
ww....wwww..w
w.....A.....w
w.www.w.www.w
w.w.+.w...11w
wwwwwwwwwwwww
