wwwwwwwwwwwww
w...+.......w
w1......w...w
w........A..w
w.w.w.w...w.w
w...........w
w...w.....w.w
w.g3........w
wwwwwwwwwwwww
