wwwwwwwwwwwww
w...2.....g.w
w.w..ww2....w
w...........w
w+w...w.w.w.w
w...........w
w.wA.ww.....w
w...........w
wwwwwwwwwwwww
