wwwwwwwwwwwww
w..........Aw
w...w.w.....w
w...........w
w.......w.w.w
w2g.........w
w.......w.+.w
w.3.........w
wwwwwwwwwwwww
