wwwwwwwwwwwww
w.....w....Aw
w.w...w.w.w.w
w.........w.w
w.w..+w.....w
w...........w
w2....w.....w
wg..........w
wwwwwwwwwwwww
