wwwwwwwwwwwww
w...........w
w.g.........w
w...........w
w...........w
w...........w
w+....wAw...w
w...........w
wwwwwwwwwwwww
