wwwwwwwwwwwww
w.....A.....w
w.w.w.w.ww..w
w...........w
w+....w.w.w.w
w.w...w....gw
www2.ww...w.w
w.......2.2.w
wwwwwwwwwwwww
