wwwwwwwwwwwww
w...w.....1gw
ww..w...w.w2w
w...........w
w.w...w.w.1.w
w.....w.w...w
w.A...w.w.www
w+..........w
wwwwwwwwwwwww
