wwwwwwwwwwwww
w....A..w...w
w...w.......w
w...........w
w...w.....w.w
w...........w
w+w.w....ww.w
w.........g3w
wwwwwwwwwwwww
