wwwwwwwwwwwww
w.w.........w
w.....w....1w
w.......g.w1w
w+..w...w...w
w...........w
w...w.www.w.w
w.A.........w
wwwwwwwwwwwww
