wwwwwwwwwwwww
wA.........+w
w.w.w...w..ww
w.w.........w
w.w.w...w.w.w
w...w......3w
w.w.www.w.w.w
w...g....2..w
wwwwwwwwwwwww
