wwwwwwwwwwwww
w......3...+w
w...w...w1..w
w...w...w...w
w...www.w.g.w
w...........w
w.www.w.....w
wAw.........w
wwwwwwwwwwwww
