wwwwwwwwwwwww
w.......+...w
ww......w.w.w
w...g.......w
w1..w.......w
w1..........w
w.......wA..w
w...w.......w
wwwwwwwwwwwww
