wwwwwwwwwwwww
w..........+w
w.w.w..Aw...w
w...........w
w.w.w.....w.w
w...........w
w..2w.......w
w.g.........w
wwwwwwwwwwwww
