wwwwwwwwwwwww
w...w.......w
w.www.ww....w
wg........w.w
ww.w......w.w
w1........A.w
w+ww.....w..w
w2w..3w.....w
wwwwwwwwwwwww
