wwwwwwwwwwwww
w...........w
w.wA..w...wgw
w...........w
w..w..w.....w
w...........w
w...w.......w
w.3.+....2..w
wwwwwwwwwwwww
