wwwwwwwwwwwww
w3......w...w
w...g...w...w
w3..........w
w.....www...w
w.......A...w
w...w.......w
w.......w..+w
wwwwwwwwwwwww
