wwwwwwwwwwwww
w..........3w
wAw.w...w.w.w
w...........w
w.w..+w.w.w.w
w...........w
w...........w
w.........g.w
wwwwwwwwwwwww
