wwwwwwwwwwwww
w....A...1..w
w.w.....w...w
w...........w
w.w.....w...w
w+..........w
w.w.........w
w.........g2w
wwwwwwwwwwwww
