wwwwwwwwwwwww
wA......w...w
w...w.w.w...w
w...........w
w.w.w...w.w.w
w.........g.w
w+www.w.w.w3w
w...w.w..3..w
wwwwwwwwwwwww
