wwwwwwwwwwwww
w.1......2..w
w..+ww...1wgw
w...........w
w...wwwww.www
w.w.........w
wwwww.A.w.w.w
w...........w
wwwwwwwwwwwww
