wwwwwwwwwwwww
w...........w
w.....w.....w
w.A.........w
w.....w...w3w
w...........w
w.w...w.g.w.w
w+..........w
wwwwwwwwwwwww
