wwwwwwwwwwwww
w..3......w.w
ww.g.w..w...w
w...........w
w.w.w...w.w.w
w.........w.w
w.w.w.w.w..+w
w.......A...w
wwwwwwwwwwwww
