wwwwwwwwwwwww
w.....A.....w
w...w.w.....w
w...........w
w.w.w.w....+w
w...........w
w.....w...2.w
wg.........3w
wwwwwwwwwwwww
