wwwwwwwwwwwww
w...........w
w..A........w
w........g..w
w.........w.w
w...........w
w...w.w...w.w
w.........+.w
wwwwwwwwwwwww
