wwwwwwwwwwwww
w....+.....3w
ww..w.w.w.www
w.....w..3..w
w...w.w...w.w
wA......w..gw
www.wwwwwww3w
w.........w.w
wwwwwwwwwwwww
