wwwwwwwwwwwww
w...........w
w..A....w.w.w
w..........+w
w...........w
w...........w
w...........w
w.......g..3w
wwwwwwwwwwwww
