wwwwwwwwwwwww
w...........w
w...A.......w
w...........w
w.w.w.w.w...w
w.......2..gw
w....ww...w.w
w..+......2.w
wwwwwwwwwwwww
