wwwwwwwwwwwww
w.........g3w
w.....w....ww
w..........3w
w.w.......w.w
w..........+w
w.w.....w.w.w
wA..........w
wwwwwwwwwwwww
