wwwwwwwwwwwww
w.....w.w...w
w.w.w.w...wAw
w...........w
w...ww..w.www
w1......+...w
w2w....ww...w
w..g....w...w
wwwwwwwwwwwww
