wwwwwwwwwwwww
w..........+w
w...........w
w..A........w
w.w.w.w.....w
w..........3w
w...........w
w.........g2w
wwwwwwwwwwwww
