wwwwwwwwwwwww
w1w..g......w
w...w..ww...w
w.......w...w
w3w.www.w...w
w...........w
w........Aw.w
w+..........w
wwwwwwwwwwwww
