wwwwwwwwwwwww
w..........gw
w...w.w1....w
w..........3w
w.w.w.....w.w
w...........w
w.......w.w.w
w+..A.......w
wwwwwwwwwwwww
