wwwwwwwwwwwww
w+....w.....w
w....Aw.w.w1w
w...........w
w.www......ww
w...........w
w.w.w.w....2w
w.w........gw
wwwwwwwwwwwww
