wwwwwwwwwwwww
w+..........w
w...........w
w...........w
w3....w.w..gw
w...A.......w
w.w.w.......w
w..........3w
wwwwwwwwwwwww
