wwwwwwwwwwwww
w...........w
w.wA..w.....w
w...........w
w...w.......w
w..........1w
w.w.w.......w
w+.........gw
wwwwwwwwwwwww
