wwwwwwwwwwwww
w.1.........w
w...........w
w.....A.....w
w.........+.w
w3..........w
w...w.w.....w
wg..........w
wwwwwwwwwwwww
