wwwwwwwwwwwww
w.........w.w
w.w...www..Aw
w+2.........w
w...w.w...w.w
w.g.........w
w...w.w.....w
w.22........w
wwwwwwwwwwwww
