wwwwwwwwwwwww
w.A.w.......w
w...w.www...w
w.........w.w
w.ww...ww.w.w
w.w.......g.w
w.ww......w.w
w..+..w..232w
wwwwwwwwwwwww
