wwwwwwwwwwwww
w.....A.....w
w+..w.w.w...w
w...........w
w.w.w...w.wgw
w..........1w
w....1....w.w
w...........w
wwwwwwwwwwwww
