wwwwwwwwwwwww
w..........+w
w...w.....w.w
w..........2w
wg..w.w.....w
w.....A.....w
w...w.w.w.w.w
w..........2w
wwwwwwwwwwwww
