wwwwwwwwwwwww
w..g2...w...w
ww....w.w...w
w.........w.w
w.w.w.w.w.A.w
w.w.......w.w
w.....w.w.w.w
w1...1.....+w
wwwwwwwwwwwww
