wwwwwwwwwwwww
w...........w
w.w.w.w.w...w
w..A........w
w+www...w.w.w
w.....w.w.1.w
www.w.w.w.w.w
w.....w.g.1.w
wwwwwwwwwwwww
