wwwwwwwwwwwww
w...........w
w.A.w...w.w.w
w...........w
w...www...wgw
w...w.......w
w.w.w+w..3w.w
w.....1.w...w
wwwwwwwwwwwww
