wwwwwwwwwwwww
w.......g...w
w.w...w.....w
w...........w
w.w...w.....w
wA..........w
w.w.........w
w..........+w
wwwwwwwwwwwww
