wwwwwwwwwwwww
w..3......g2w
w.w......ww.w
w...........w
w...w.w..w..w
w....A......w
w+....w.w...w
w...w.......w
wwwwwwwwwwwww
