wwwwwwwwwwwww
w.......+...w
w.w.......w.w
w.........A.w
w.......w.w.w
wg2.1.......w
w.www.w.w.w.w
w.w.........w
wwwwwwwwwwwww
