wwwwwwwwwwwww
w.......2..+w
w...w.w.w...w
w...........w
w...w...w.w.w
wg..........w
w.w...A.....w
w...........w
wwwwwwwwwwwww
