wwwwwwwwwwwww
w.......1.w.w
w...ww...g..w
w...........w
w...w...w.w.w
w+..........w
wwA.....w...w
w...........w
wwwwwwwwwwwww
