wwwwwwwwwwwww
w+..........w
w...w...wA..w
w...........w
w...w...w.w.w
w..1........w
w...g.w.....w
w...1.......w
wwwwwwwwwwwww
