wwwwwwwwwwwww
wA..........w
w.....w...w.w
w...........w
w.....w.w...w
w...........w
w.......w2w+w
w...g.......w
wwwwwwwwwwwww
