wwwwwwwwwwwww
wg1.........w
w...w.......w
w...........w
w.w.....w.w.w
w...........w
w.....w.....w
w+.........Aw
wwwwwwwwwwwww
