wwwwwwwwwwwww
w.........3gw
w...w.......w
w...........w
wA..........w
w...........w
w.w.....w...w
w........+..w
wwwwwwwwwwwww
