wwwwwwwwwwwww
wA..........w
w.w.w.w...w.w
w...w....g..w
w.w.w..3w...w
w..........+w
www.www...www
w.......w..2w
wwwwwwwwwwwww
