wwwwwwwwwwwww
w...........w
w....+.....Aw
w.....w.....w
w.w.w.w...w.w
w...........w
w1....w...w.w
w.g.......w.w
wwwwwwwwwwwww
