wwwwwwwwwwwww
w........1g.w
w.w......2w.w
w.........3.w
w.w...www.w.w
w.....w.....w
w.....w...w.w
w+...A......w
wwwwwwwwwwwww
