wwwwwwwwwwwww
w.........w+w
w.A.......w.w
w.........w1w
w.....w...w.w
w.........3.w
w..........gw
w...........w
wwwwwwwwwwwww
