wwwwwwwwwwwww
w.....w.....w
ww....w.w.wgw
w.+.....w...w
ww..w...w...w
w........2..w
wA..w.w..ww.w
w...w.....w.w
wwwwwwwwwwwww
