wwwwwwwwwwwww
w..+....w.31w
w.....w.w...w
w...w...w.w.w
w.w.w.www.www
w...........w
w....ww.w.wgw
wAw.....w.w.w
wwwwwwwwwwwww
