wwwwwwwwwwwww
w.........A.w
w.....w.w...w
w..+........w
w...........w
w...........w
w.......w...w
wg..........w
wwwwwwwwwwwww
