wwwwwwwwwwwww
w...........w
w.w.w...wg..w
w..........2w
w...w.w.w...w
w....A......w
w.w2..w....1w
w.......w.+.w
wwwwwwwwwwwww
