wwwwwwwwwwwww
w.+....3....w
w.w.....w...w
w..A........w
w.w.........w
w...........w
w...w.....w.w
w.......g.2.w
wwwwwwwwwwwww
