wwwwwwwwwwwww
w..........+w
ww....wA....w
w...........w
www.w...w...w
w.......w...w
w.w.....w...w
w.2g........w
wwwwwwwwwwwww
