wwwwwwwwwwwww
w2..........w
ww..w....gw.w
w...........w
w.........w.w
w.....A.....w
w.w...w.w...w
w.w..+......w
wwwwwwwwwwwww
