wwwwwwwwwwwww
w.wA........w
w.w.w.ww..w.w
w+....w.....w
w.....w...www
w...........w
w..w..w.w..gw
w....3....2.w
wwwwwwwwwwwww
