wwwwwwwwwwwww
w...........w
w.....g...w.w
w...........w
w.w.w.....w.w
w.........+.w
wA......w...w
w......2....w
wwwwwwwwwwwww
