wwwwwwwwwwwww
w........g..w
w.......w2w.w
w...........w
w+..w...w...w
w...........w
w...wA......w
w...........w
wwwwwwwwwwwww
