wwwwwwwwwwwww
w.+........3w
w.w...ww...gw
w..........1w
w.w...w.....w
w.w.......w.w
w.wwwww...w.w
w....A....w.w
wwwwwwwwwwwww
