wwwwwwwwwwwww
w.........w.w
w.w.w.wA..w.w
w...w.....w.w
w+w..3w...w.w
w...........w
w.w.w3ww....w
w.w......g..w
wwwwwwwwwwwww
