wwwwwwwwwwwww
w...........w
w..Aw...w...w
w...........w
w.w.w.w.....w
w+..........w
w.w...w...w.w
w......3...gw
wwwwwwwwwwwww
