wwwwwwwwwwwww
w.....+.....w
w3......w.w.w
w1..........w
w.......w..Aw
w...........w
w.........w.w
wg..........w
wwwwwwwwwwwww
