wwwwwwwwwwwww
w.w...A.....w
w.......www.w
w...........w
w...w...w...w
w...........w
w.www..2w..+w
w1g.w.....w.w
wwwwwwwwwwwww
