wwwwwwwwwwwww
w...w...A...w
w.w....ww.w.w
w.w.........w
www.w...w.w.w
w..gw.....w.w
w..ww..ww.w.w
w2+........1w
wwwwwwwwwwwww
