wwwwwwwwwwwww
w.........w.w
w..+..w...w.w
w...........w
wA.........ww
w.........3gw
w...w.w.....w
w.......w..2w
wwwwwwwwwwwww
