wwwwwwwwwwwww
w........112w
w.www.w.g.w.w
w.w.w.w...w.w
w...w.www.w.w
w.....w.....w
w...w.w.w...w
w.wA....w+w.w
wwwwwwwwwwwww
