wwwwwwwwwwwww
wA..........w
w...w.w..+..w
w...........w
w.w.w...w...w
w......g....w
w.........w.w
w......1....w
wwwwwwwwwwwww
