wwwwwwwwwwwww
w.........+.w
w.w.........w
w...........w
w.....w.....w
w.......A...w
wgw.w.....w.w
w...........w
wwwwwwwwwwwww
