wwwwwwwwwwwww
w...........w
w+A.....w.w.w
w.....w.....w
ww.w.2w.....w
w.....w...w3w
wwww..w...w.w
w........g..w
wwwwwwwwwwwww
