wwwwwwwwwwwww
w.....+.....w
w.w...w.w...w
w..........Aw
w.......w...w
w...........w
wg......w...w
w.3.........w
wwwwwwwwwwwww
