wwwwwwwwwwwww
w.A.........w
w...w.w...w.w
w...w.w.....w
w.....ww.gw.w
w.........w.w
w...www..22+w
w...........w
wwwwwwwwwwwww
