wwwwwwwwwwwww
w+..A.......w
w..........ww
w.......2...w
www.ww..w.www
w...........w
w.w...w...1.w
w.....w...g.w
wwwwwwwwwwwww
