wwwwwwwwwwwww
w.........w2w
w.www.www.w.w
w1....A.w...w
w.w...w.w.w.w
w.....w.w...w
w.w...w.....w
w.g.......+2w
wwwwwwwwwwwww
