wwwwwwwwwwwww
w.......+...w
w.........w.w
w...........w
w.......2.3.w
wA..........w
w........ww.w
w...w.....wgw
wwwwwwwwwwwww
