wwwwwwwwwwwww
w.+.........w
w.....w.w...w
w.....A.....w
w.w.w.w.w...w
w.......w...w
w......ww..1w
w.......3.g.w
wwwwwwwwwwwww
