wwwwwwwwwwwww
w........1+2w
w...w...w...w
w...........w
w.w...w.wgwww
w...........w
w..Awww.....w
w...........w
wwwwwwwwwwwww
