wwwwwwwwwwwww
w..........+w
w.....wA....w
w...........w
w.....w.w...w
w...........w
w3......w...w
w..g........w
wwwwwwwwwwwww
