wwwwwwwwwwwww
w..A........w
w...w..w....w
w...........w
w.w.w.w...w1w
w+.........1w
w...w.w...wgw
w...........w
wwwwwwwwwwwww
