wwwwwwwwwwwww
wg..........w
w...w.....w.w
w...........w
w...w...w.wAw
w...........w
w..2w.w.....w
w.2...+.....w
wwwwwwwwwwwww
