wwwwwwwwwwwww
wg2........+w
w.www.w.w.w.w
w.....w.....w
w1..w...w...w
w...........w
w..ww.A...w.w
w.........w.w
wwwwwwwwwwwww
