wwwwwwwwwwwww
w.A.w+w.....w
w...w.www...w
w...........w
w.w.w.wwwww.w
w........g.3w
w.........w.w
w.....1.....w
wwwwwwwwwwwww
