wwwwwwwwwwwww
w........+w3w
w.w.....w.w.w
w.....w.....w
wA........w3w
w........gw.w
w...w.w...w.w
w...........w
wwwwwwwwwwwww
