wwwwwwwwwwwww
w+.......2..w
w.w.wAw.w...w
w...........w
w...........w
w...........w
w...w.w...w1w
w.........g.w
wwwwwwwwwwwww
