wwwwwwwwwwwww
w+1g........w
w.......w...w
w...........w
w.w...w.w...w
w...........w
w.........A.w
w...........w
wwwwwwwwwwwww
