wwwwwwwwwwwww
w....A......w
w.........w.w
w...........w
w...w.....w.w
w........g2.w
w+w.w.w.w2w.w
w...........w
wwwwwwwwwwwww
