wwwwwwwwwwwww
w+..........w
w...w.w...w.w
w...........w
w.w.......w.w
w..........Aw
w1w...w.....w
w.g2........w
wwwwwwwwwwwww
