wwwwwwwwwwwww
w...........w
w.w.......g.w
w...........w
w.w...+....2w
w.A.........w
w.....w.....w
w...........w
wwwwwwwwwwwww
