wwwwwwwwwwwww
w...........w
w..A....w...w
w...........w
w...w.....w.w
w+.........2w
w...w.w....gw
w.........1.w
wwwwwwwwwwwww
