wwwwwwwwwwwww
w..........gw
w.......w.w.w
w......A....w
w.w.......w.w
w...........w
w.1...w.....w
w..+........w
wwwwwwwwwwwww
