wwwwwwwwwwwww
w...........w
w...w......gw
w...........w
w...w..2....w
w....A......w
w+........w.w
w...........w
wwwwwwwwwwwww
