wwwwwwwwwwwww
w......+....w
w.........w.w
w1........A.w
w.....w.....w
w...........w
w.w...w.w...w
w....g......w
wwwwwwwwwwwww
