wwwwwwwwwwwww
w.......1.w3w
w.w...w..ww.w
w.........g.w
www...w.w...w
w.w.w...w.w.w
w.w.w.w.w.w.w
w+.A......w.w
wwwwwwwwwwwww
