wwwwwwwwwwwww
w.........w.w
wAw.w...w...w
w...........w
w.w...w.w..2w
w...w...w2g.w
w.....w.w.w.w
w...w...+.w.w
wwwwwwwwwwwww
