wwwwwwwwwwwww
w+..........w
w...w.w.w..3w
w..........1w
w..A..w.w...w
w........gw.w
w.w.....w.w.w
w..........1w
wwwwwwwwwwwww
