wwwwwwwwwwwww
w+..........w
w.....1...w.w
w...........w
wA..........w
w.......w...w
w.ww....w.w.w
w........3g.w
wwwwwwwwwwwww
