wwwwwwwwwwwww
w.A.........w
w.......w.w.w
w...........w
w.....w.....w
w...........w
w...w.w....+w
w.......g..2w
wwwwwwwwwwwww
