wwwwwwwwwwwww
w.3.g.......w
w...........w
w...........w
w.........w.w
w...........w
w.w.w.w.....w
w.......A..+w
wwwwwwwwwwwww
