wwwwwwwwwwwww
w3.....g....w
w3ww..w...w.w
w.w+........w
w.w.w.....w.w
w...w.......w
w........wwAw
w...........w
wwwwwwwwwwwww
