wwwwwwwwwwwww
w...w......3w
w.........+.w
w..A....w1..w
w.......w...w
w...........w
w.w...ww....w
w........g..w
wwwwwwwwwwwww
