wwwwwwwwwwwww
w...........w
www.w.wAwww.w
w.+...w.w...w
www.w...ww..w
w.3.........w
www.w.w.ww..w
w2.........gw
wwwwwwwwwwwww
