wwwwwwwwwwwww
w..........gw
w.w1........w
w...........w
w...w.......w
w...........w
w+w.wA..w.w.w
w...........w
wwwwwwwwwwwww
