wwwwwwwwwwwww
w..........Aw
w.w.w.w.....w
w...........w
w...........w
w3..........w
w...........w
wg........+.w
wwwwwwwwwwwww
