wwwwwwwwwwwww
w.w..1w.+..1w
w....ww...www
w.w..g......w
w...ww..w...w
w...........w
wA...w.ww.w.w
w...........w
wwwwwwwwwwwww
