wwwwwwwwwwwww
w...........w
w.......wA..w
w...........w
w.......w.w.w
w...........w
w3w.w.w...w.w
wg.1.......+w
wwwwwwwwwwwww
