wwwwwwwwwwwww
w.........g.w
w.w...w...w.w
w...........w
w.w...w.....w
wA..........w
w.w.....w..2w
w....+...2..w
wwwwwwwwwwwww
