wwwwwwwwwwwww
w3..+.......w
w.....w.wAw.w
w.....w.w...w
w.w.........w
w...........w
w1w.w...w..ww
w..g........w
wwwwwwwwwwwww
