wwwwwwwwwwwww
w........A..w
w+w...w.....w
w...........w
w.w...w.....w
w...........w
w.w.....w.w.w
w3....g.....w
wwwwwwwwwwwww
