wwwwwwwwwwwww
w...........w
w3..w.w....+w
w...........w
w...w.w.w...w
w...........w
w.w.....w.A.w
wg..........w
wwwwwwwwwwwww
