wwwwwwwwwwwww
w+.......3g1w
www.www..ww.w
w...........w
w.....w.w.3.w
w.....w.....w
w.w.w.w...www
w.A.........w
wwwwwwwwwwwww
