wwwwwwwwwwwww
wg..........w
w...........w
w...........w
w...w.......w
w..........Aw
w...w.......w
w.....+.....w
wwwwwwwwwwwww
