wwwwwwwwwwwww
w..........+w
w.w.w.w.....w
w2..........w
w.w.w.wA....w
w...........w
w.......w...w
wg..........w
wwwwwwwwwwwww
