wwwwwwwwwwwww
wA..........w
w.w.w.w...w.w
w.......3.+.w
w.w.........w
w.....wg....w
w.w.....w.w1w
w.....w.w...w
wwwwwwwwwwwww
