wwwwwwwwwwwww
w.w.........w
w...w.w2w...w
w..3w......gw
w.w...w.w...w
w...........w
w........ww.w
wA.......+..w
wwwwwwwwwwwww
