wwwwwwwwwwwww
wA..........w
w.....w.....w
w...........w
w.....w.....w
w.........+.w
w.w.....w...w
w.........3gw
wwwwwwwwwwwww
