wwwwwwwwwwwww
w1.3w.....w.w
w.w.www...w.w
w.g...w.....w
w.w.......w.w
w.......A.w.w
w.......w.w.w
w2.........+w
wwwwwwwwwwwww
