wwwwwwwwwwwww
w.A.........w
w.....w...w.w
w...........w
w.........wgw
w.........3.w
w.w.w..1....w
w+..........w
wwwwwwwwwwwww
