wwwwwwwwwwwww
w.........+Aw
w.....w.....w
w...........w
w.ww....w.w.w
w.....w.....w
w.w.1.w.w.www
w.g.....3...w
wwwwwwwwwwwww
