wwwwwwwwwwwww
wg..........w
w.......w.w.w
w...........w
w.w3w.......w
w...wA......w
www.w.....w.w
w........+.3w
wwwwwwwwwwwww
