wwwwwwwwwwwww
w.......g..1w
w.w.........w
w..A........w
w.w.........w
w...........w
w.w.......+.w
w...........w
wwwwwwwwwwwww
