wwwwwwwwwwwww
w.A.........w
w..w..www.w.w
w...........w
w+.ww.www.3.w
w..........gw
w.w.w...www.w
w.w.......2.w
wwwwwwwwwwwww
