wwwwwwwwwwwww
w........1..w
w........g..w
w...........w
w...w.w...w.w
w...........w
wAw.w+......w
w...........w
wwwwwwwwwwwww
