wwwwwwwwwwwww
w...w.....w3w
w.www.w.w.g2w
w.......w..3w
w.ww..w.w.w.w
w.....w.....w
w+w.wAw...w.w
w...........w
wwwwwwwwwwwww
