wwwwwwwwwwwww
wg...3......w
w.w.....w..ww
w...........w
www....ww..ww
w.......A...w
w.w.........w
w.........+.w
wwwwwwwwwwwww
