wwwwwwwwwwwww
w...........w
w+..g...www.w
w...w.w.....w
w.w.w.w.w.A.w
w.........w.w
w.w...w...w.w
w1..2.......w
wwwwwwwwwwwww
