wwwwwwwwwwwww
w..........gw
w.w.....w.w2w
w...........w
w.w.A...w.w.w
w...........w
w.w.w...w...w
w.+...2.....w
wwwwwwwwwwwww
