wwwwwwwwwwwww
w.......g...w
w3w.w.w.....w
w.....w.....w
w...www.w.w.w
w.w.....w...w
w.w.w...w.w.w
w+1........Aw
wwwwwwwwwwwww
