wwwwwwwwwwwww
w3..........w
wgw.........w
w...........w
w.w...w.A...w
w...........w
w...w.w.....w
w2.........+w
wwwwwwwwwwwww
