wwwwwwwwwwwww
w...........w
w.w.....w+www
w.........w.w
w.w...w.A.w.w
w...........w
w.w...w.....w
w2g..2......w
wwwwwwwwwwwww
