wwwwwwwwwwwww
w.........A.w
w.w.w...w.w.w
w...........w
w.wgw.......w
w...........w
w.w.........w
w2..3...+...w
wwwwwwwwwwwww
