wwwwwwwwwwwww
w........2..w
w.....w...w+w
w..g...2....w
ww....w.....w
w.....A.....w
w.w...w...w.w
w...........w
wwwwwwwwwwwww
