wwwwwwwwwwwww
w+........3gw
w.w.w.....w.w
w...........w
w...w.......w
w...........w
w.....w.w...w
w....A......w
wwwwwwwwwwwww
