wwwwwwwwwwwww
w...........w
w.w.+.w...w.w
w...........w
w...w.w...A.w
w...........w
w.....w.w.w.w
wg.3........w
wwwwwwwwwwwww
