wwwwwwwwwwwww
w..........+w
w.w.w...w...w
w...........w
w...w.......w
w.g.....A...w
w...w...w...w
w...........w
wwwwwwwwwwwww
