wwwwwwwwwwwww
w...........w
w.....w.A...w
w...........w
w...w.w.....w
w..........+w
w..g....w...w
w2......w...w
wwwwwwwwwwwww
