wwwwwwwwwwwww
w...........w
w.....wAw...w
w2........w.w
w.www...w.w.w
wg..........w
w2.........+w
w.....w.....w
wwwwwwwwwwwww
