wwwwwwwwwwwww
w........g..w
w...w.....w.w
w...A.......w
w.......w...w
w...........w
w.......w...w
w..+.......2w
wwwwwwwwwwwww
