wwwwwwwwwwwww
w.g.........w
w3......w.w.w
w...........w
w...w...w...w
w..........+w
w.....A.w...w
w...........w
wwwwwwwwwwwww
