wwwwwwwwwwwww
w.........wgw
w.....w.w.w.w
w+.....A....w
w...w.w.w.w.w
w.w...w.....w
w3www.w.....w
w1..........w
wwwwwwwwwwwww
