wwwwwwwwwwwww
w...........w
w...w.w.w.w.w
w1......A..+w
w...w.......w
w...........w
w.......w...w
wg..........w
wwwwwwwwwwwww
