wwwwwwwwwwwww
w...........w
w..A.ww...w.w
w...........w
w...w...w...w
w...w......gw
w.w.w..ww.w.w
w+.........2w
wwwwwwwwwwwww
