wwwwwwwwwwwww
w1.........2w
w+www...w.w.w
w....A.....1w
w.....w...w.w
w...........w
w...w...w.wgw
w...w.......w
wwwwwwwwwwwww
