wwwwwwwwwwwww
w...........w
w.........w1w
w.........g.w
w.A.w.w.w.w.w
w...........w
w+w.....w...w
w.........1.w
wwwwwwwwwwwww
