wwwwwwwwwwwww
w.....w..g.3w
w.ww....w.www
w.........w.w
ww..ww.w....w
w...w.....3.w
w...w.ww..w.w
wA....w....+w
wwwwwwwwwwwww
