wwwwwwwwwwwww
wg..........w
w..w....w...w
w.....2.....w
w.w.....www.w
w3..........w
w....ww.w..Aw
w....+......w
wwwwwwwwwwwww
