wwwwwwwwwwwww
w...........w
w.www..wA..+w
w...........w
w...........w
w...........w
w1g1w.w.w...w
w...w.......w
wwwwwwwwwwwww
