wwwwwwwwwwwww
w...........w
w.ww..w.wg.1w
wA....w.w...w
w.w.....www.w
w.w.........w
w.w.w.w.w..1w
w.w.+......1w
wwwwwwwwwwwww
