wwwwwwwwwwwww
w.......A...w
w.w...w.....w
w...........w
w..........gw
w3..........w
w3+.w.w.w...w
w...........w
wwwwwwwwwwwww
