wwwwwwwwwwwww
w......1+...w
w.w.w...w...w
w.g.........w
w...www.1...w
w...w.......w
w.www1....www
w......A....w
wwwwwwwwwwwww
