wwwwwwwwwwwww
w...+.......w
w.....w.wAw.w
w...........w
w...w.w...w.w
w...2.......w
w.......w...w
wg..........w
wwwwwwwwwwwww
