wwwwwwwwwwwww
w.....w.....w
w.w.w...w.w+w
w......A....w
w.w..ww...w.w
w..g........w
w.2...w.....w
w3..........w
wwwwwwwwwwwww
