wwwwwwwwwwwww
w..........+w
w........A..w
w...........w
w...w.w.w...w
w...........w
w.1g....w.w.w
w...........w
wwwwwwwwwwwww
