wwwwwwwwwwwww
w.+..g......w
w.....w...w.w
w.........2.w
w.1.w.w.w.www
w...........w
w.w...w.w...w
w......A....w
wwwwwwwwwwwww
