wwwwwwwwwwwww
w......1.g..w
w.....w.w...w
w...........w
w.........w.w
w1..........w
w+..wA..w...w
w...........w
wwwwwwwwwwwww
