wwwwwwwwwwwww
wg..........w
w.........w.w
w...........w
w.w.w...w...w
w........A..w
w.w...w.w...w
w..........+w
wwwwwwwwwwwww
