wwwwwwwwwwwww
w.......g.22w
w.wwwww.w...w
w...w.w.w...w
w...w.w.w.w.w
w.....w...w.w
wA....ww..w.w
w.w.....+...w
wwwwwwwwwwwww
